"year","date","democrat","republican","electionday","daysuntil","d.poll.margin","d.actual.share","r.actual.share","d.actual.margin"
1980,"1979-10-01",53,33,"11/4/1980",400,20,41,50.7,-9.7
1980,"1979-10-25",45,41,"11/4/1980",376,4,41,50.7,-9.7
1980,"1979-10-25",45,41,"11/4/1980",376,4,41,50.7,-9.7
1980,"1979-11-10",53,42,"11/4/1980",360,11,41,50.7,-9.7
1980,"1979-11-12",47,42,"11/4/1980",358,5,41,50.7,-9.7
1980,"1979-11-12",47,42,"11/4/1980",358,5,41,50.7,-9.7
1980,"1979-11-19",48,42,"11/4/1980",351,6,41,50.7,-9.7
1980,"1979-11-29",53,44,"11/4/1980",341,9,41,50.7,-9.7
1980,"1979-12-04",57,35,"11/4/1980",336,22,41,50.7,-9.7
1980,"1979-12-09",60,36,"11/4/1980",331,24,41,50.7,-9.7
1980,"1979-12-12",50,36,"11/4/1980",328,14,41,50.7,-9.7
1980,"1979-12-16",59,36,"11/4/1980",324,23,41,50.7,-9.7
1980,"1979-12-30",59,36,"11/4/1980",310,23,41,50.7,-9.7
1980,"1980-01-01",49,39,"11/4/1980",308,10,41,50.7,-9.7
1980,"1980-01-06",63,32,"11/4/1980",303,31,41,50.7,-9.7
1980,"1980-01-22",65,31,"11/4/1980",287,34,41,50.7,-9.7
1980,"1980-02-03",60,31,"11/4/1980",275,29,41,50.7,-9.7
1980,"1980-03-02",57,34,"11/4/1980",247,23,41,50.7,-9.7
1980,"1980-03-08",58,40,"11/4/1980",241,18,41,50.7,-9.7
1980,"1980-03-20",45,44,"11/4/1980",229,1,41,50.7,-9.7
1980,"1980-03-30",38,38,"11/4/1980",219,0,41,50.7,-9.7
1980,"1980-03-30",48,43,"11/4/1980",219,5,41,50.7,-9.7
1980,"1980-03-30",40,34,"11/4/1980",219,6,41,50.7,-9.7
1980,"1980-03-30",43,44,"11/4/1980",219,-1,41,50.7,-9.7
1980,"1980-04-01",33,31,"11/4/1980",217,2,41,50.7,-9.7
1980,"1980-04-08",45,48,"11/4/1980",210,-3,41,50.7,-9.7
1980,"1980-04-13",51,42,"11/4/1980",205,9,41,50.7,-9.7
1980,"1980-04-13",51,42,"11/4/1980",205,9,41,50.7,-9.7
1980,"1980-04-13",42,35,"11/4/1980",205,7,41,50.7,-9.7
1980,"1980-04-14",42,34,"11/4/1980",204,8,41,50.7,-9.7
1980,"1980-04-25",33,42,"11/4/1980",193,-9,41,50.7,-9.7
1980,"1980-04-27",38,32,"11/4/1980",191,6,41,50.7,-9.7
1980,"1980-04-30",33,39,"11/4/1980",188,-6,41,50.7,-9.7
1980,"1980-05-05",38,33,"11/4/1980",183,5,41,50.7,-9.7
1980,"1980-05-19",40,32,"11/4/1980",169,8,41,50.7,-9.7
1980,"1980-05-22",37,36,"11/4/1980",166,1,41,50.7,-9.7
1980,"1980-06-01",48,41,"11/4/1980",156,7,41,50.7,-9.7
1980,"1980-06-01",39,32,"11/4/1980",156,7,41,50.7,-9.7
1980,"1980-06-08",43,45,"11/4/1980",149,-2,41,50.7,-9.7
1980,"1980-06-08",36,40,"11/4/1980",149,-4,41,50.7,-9.7
1980,"1980-06-09",44,50,"11/4/1980",148,-6,41,50.7,-9.7
1980,"1980-06-09",34,39,"11/4/1980",148,-5,41,50.7,-9.7
1980,"1980-06-09",44,51,"11/4/1980",148,-7,41,50.7,-9.7
1980,"1980-06-12",36,40,"11/4/1980",145,-4,41,50.7,-9.7
1980,"1980-06-12",29,34,"11/4/1980",145,-5,41,50.7,-9.7
1980,"1980-06-15",42,45,"11/4/1980",142,-3,41,50.7,-9.7
1980,"1980-06-15",35,33,"11/4/1980",142,2,41,50.7,-9.7
1980,"1980-06-16",45,42,"11/4/1980",141,3,41,50.7,-9.7
1980,"1980-06-16",31,39,"11/4/1980",141,-8,41,50.7,-9.7
1980,"1980-06-22",37,47,"11/4/1980",135,-10,41,50.7,-9.7
1980,"1980-06-22",36,49,"11/4/1980",135,-13,41,50.7,-9.7
1980,"1980-06-22",28,43,"11/4/1980",135,-15,41,50.7,-9.7
1980,"1980-06-22",30,41,"11/4/1980",135,-11,41,50.7,-9.7
1980,"1980-06-29",41,47,"11/4/1980",128,-6,41,50.7,-9.7
1980,"1980-06-29",32,37,"11/4/1980",128,-5,41,50.7,-9.7
1980,"1980-07-01",37,31,"11/4/1980",126,6,41,50.7,-9.7
1980,"1980-07-09",27,42,"11/4/1980",118,-15,41,50.7,-9.7
1980,"1980-07-13",40,40,"11/4/1980",114,0,41,50.7,-9.7
1980,"1980-07-13",31,33,"11/4/1980",114,-2,41,50.7,-9.7
1980,"1980-07-14",34,37,"11/4/1980",113,-3,41,50.7,-9.7
1980,"1980-07-16",26,37,"11/4/1980",111,-11,41,50.7,-9.7
1980,"1980-07-16",28,46,"11/4/1980",111,-18,41,50.7,-9.7
1980,"1980-07-21",26,53,"11/4/1980",106,-27,41,50.7,-9.7
1980,"1980-07-21",33,61,"11/4/1980",106,-28,41,50.7,-9.7
1980,"1980-08-03",25,51,"11/4/1980",93,-26,41,50.7,-9.7
1980,"1980-08-03",33,60,"11/4/1980",93,-27,41,50.7,-9.7
1980,"1980-08-04",31,45,"11/4/1980",92,-14,41,50.7,-9.7
1980,"1980-08-06",28,48,"11/4/1980",90,-20,41,50.7,-9.7
1980,"1980-08-06",36,57,"11/4/1980",90,-21,41,50.7,-9.7
1980,"1980-08-07",27,47,"11/4/1980",89,-20,41,50.7,-9.7
1980,"1980-08-07",22,47,"11/4/1980",89,-25,41,50.7,-9.7
1980,"1980-08-16",32,39,"11/4/1980",80,-7,41,50.7,-9.7
1980,"1980-08-16",37,48,"11/4/1980",80,-11,41,50.7,-9.7
1980,"1980-08-18",36,42,"11/4/1980",78,-6,41,50.7,-9.7
1980,"1980-08-18",46,40,"11/4/1980",78,6,41,50.7,-9.7
1980,"1980-08-18",39,38,"11/4/1980",78,1,41,50.7,-9.7
1980,"1980-08-23",37,38,"11/4/1980",73,-1,41,50.7,-9.7
1980,"1980-08-28",39,39,"11/4/1980",68,0,41,50.7,-9.7
1980,"1980-09-03",37,37,"11/4/1980",62,0,41,50.7,-9.7
1980,"1980-09-07",37,37,"11/4/1980",58,0,41,50.7,-9.7
1980,"1980-09-07",37,41,"11/4/1980",58,-4,41,50.7,-9.7
1980,"1980-09-07",46,48,"11/4/1980",58,-2,41,50.7,-9.7
1980,"1980-09-14",38,35,"11/4/1980",51,3,41,50.7,-9.7
1980,"1980-09-15",38,40,"11/4/1980",50,-2,41,50.7,-9.7
1980,"1980-09-15",37,41,"11/4/1980",50,-4,41,50.7,-9.7
1980,"1980-09-21",40,36,"11/4/1980",44,4,41,50.7,-9.7
1980,"1980-09-24",33,42,"11/4/1980",41,-9,41,50.7,-9.7
1980,"1980-09-25",35,40,"11/4/1980",40,-5,41,50.7,-9.7
1980,"1980-09-25",35,39,"11/4/1980",40,-4,41,50.7,-9.7
1980,"1980-10-01",35,41,"11/4/1980",34,-6,41,50.7,-9.7
1980,"1980-10-06",39,43,"11/4/1980",29,-4,41,50.7,-9.7
1980,"1980-10-06",46,49,"11/4/1980",29,-3,41,50.7,-9.7
1980,"1980-10-10",35,43,"11/4/1980",25,-8,41,50.7,-9.7
1980,"1980-10-12",43,42,"11/4/1980",23,1,41,50.7,-9.7
1980,"1980-10-12",42,45,"11/4/1980",23,-3,41,50.7,-9.7
1980,"1980-10-12",36,40,"11/4/1980",23,-4,41,50.7,-9.7
1980,"1980-10-15",36.5,39.5,"11/4/1980",20,-3,41,50.7,-9.7
1980,"1980-10-16",42,41,"11/4/1980",19,1,41,50.7,-9.7
1980,"1980-10-16",39,42,"11/4/1980",19,-3,41,50.7,-9.7
1980,"1980-10-16",46,49,"11/4/1980",19,-3,41,50.7,-9.7
1980,"1980-10-20",39,38,"11/4/1980",15,1,41,50.7,-9.7
1980,"1980-10-20",39,42,"11/4/1980",15,-3,41,50.7,-9.7
1980,"1980-10-20",41,40,"11/4/1980",15,1,41,50.7,-9.7
1980,"1980-10-22",38.2,37,"11/4/1980",13,1.2,41,50.7,-9.7
1980,"1980-10-24",36,42,"11/4/1980",11,-6,41,50.7,-9.7
1980,"1980-10-26",45,42,"11/4/1980",9,3,41,50.7,-9.7
1980,"1980-10-27",42,39,"11/4/1980",8,3,41,50.7,-9.7
1980,"1980-10-27",43,39,"11/4/1980",8,4,41,50.7,-9.7
1980,"1980-10-27",35,39,"11/4/1980",8,-4,41,50.7,-9.7
1980,"1980-10-30",44,41,"11/4/1980",5,3,41,50.7,-9.7
1980,"1980-10-30",43,44,"11/4/1980",5,-1,41,50.7,-9.7
1980,"1980-11-01",44,47,"11/4/1980",3,-3,41,50.7,-9.7
1980,"1980-11-01",43,44,"11/4/1980",3,-1,41,50.7,-9.7
1980,"1980-11-01",40,45,"11/4/1980",3,-5,41,50.7,-9.7
1980,"1980-11-03",41,46,"11/4/1980",1,-5,41,50.7,-9.7
1984,"1983-10-09",46,50,"11/6/1984",394,-4,40.6,58.8,-18.2
1984,"1983-10-10",50,44,"11/6/1984",393,6,40.6,58.8,-18.2
1984,"1983-11-14",45,51,"11/6/1984",358,-6,40.6,58.8,-18.2
1984,"1983-11-14",35,47,"11/6/1984",358,-12,40.6,58.8,-18.2
1984,"1983-11-14",42,54,"11/6/1984",358,-12,40.6,58.8,-18.2
1984,"1983-11-16",36,53,"11/6/1984",356,-17,40.6,58.8,-18.2
1984,"1983-11-21",48,47,"11/6/1984",351,1,40.6,58.8,-18.2
1984,"1983-12-12",45,51,"11/6/1984",330,-6,40.6,58.8,-18.2
1984,"1983-12-12",44,51,"11/6/1984",330,-7,40.6,58.8,-18.2
1984,"1983-12-16",43,46,"11/6/1984",326,-3,40.6,58.8,-18.2
1984,"1984-01-15",44,51,"11/6/1984",296,-7,40.6,58.8,-18.2
1984,"1984-01-15",43,51,"11/6/1984",296,-8,40.6,58.8,-18.2
1984,"1984-01-15",47,48,"11/6/1984",296,-1,40.6,58.8,-18.2
1984,"1984-01-21",32,48,"11/6/1984",290,-16,40.6,58.8,-18.2
1984,"1984-01-21",41,46,"11/6/1984",290,-5,40.6,58.8,-18.2
1984,"1984-01-30",43,53,"11/6/1984",281,-10,40.6,58.8,-18.2
1984,"1984-02-02",41,51,"11/6/1984",278,-10,40.6,58.8,-18.2
1984,"1984-02-06",43,53,"11/6/1984",274,-10,40.6,58.8,-18.2
1984,"1984-02-06",40,56,"11/6/1984",274,-16,40.6,58.8,-18.2
1984,"1984-02-11",42,54,"11/6/1984",269,-12,40.6,58.8,-18.2
1984,"1984-02-11",40,56,"11/6/1984",269,-16,40.6,58.8,-18.2
1984,"1984-02-12",39,50,"11/6/1984",268,-11,40.6,58.8,-18.2
1984,"1984-02-15",45,50,"11/6/1984",265,-5,40.6,58.8,-18.2
1984,"1984-03-02",42,54,"11/6/1984",249,-12,40.6,58.8,-18.2
1984,"1984-03-03",41,55,"11/6/1984",248,-14,40.6,58.8,-18.2
1984,"1984-03-06",45,50,"11/6/1984",245,-5,40.6,58.8,-18.2
1984,"1984-03-16",35,54,"11/6/1984",235,-19,40.6,58.8,-18.2
1984,"1984-03-17",37,57,"11/6/1984",234,-20,40.6,58.8,-18.2
1984,"1984-03-18",42,54,"11/6/1984",233,-12,40.6,58.8,-18.2
1984,"1984-04-03",41,53,"11/6/1984",217,-12,40.6,58.8,-18.2
1984,"1984-04-08",38,56,"11/6/1984",212,-18,40.6,58.8,-18.2
1984,"1984-04-15",44,52,"11/6/1984",205,-8,40.6,58.8,-18.2
1984,"1984-04-26",37,55,"11/6/1984",194,-18,40.6,58.8,-18.2
1984,"1984-05-13",40,54,"11/6/1984",177,-14,40.6,58.8,-18.2
1984,"1984-05-24",40,53,"11/6/1984",166,-13,40.6,58.8,-18.2
1984,"1984-06-01",35,58,"11/6/1984",158,-23,40.6,58.8,-18.2
1984,"1984-06-08",44,53,"11/6/1984",151,-9,40.6,58.8,-18.2
1984,"1984-06-11",41,56,"11/6/1984",148,-15,40.6,58.8,-18.2
1984,"1984-06-25",37,56,"11/6/1984",134,-19,40.6,58.8,-18.2
1984,"1984-06-26",37,56,"11/6/1984",133,-19,40.6,58.8,-18.2
1984,"1984-06-28",35,50,"11/6/1984",131,-15,40.6,58.8,-18.2
1984,"1984-07-07",44,52,"11/6/1984",122,-8,40.6,58.8,-18.2
1984,"1984-07-10",33,60,"11/6/1984",119,-27,40.6,58.8,-18.2
1984,"1984-07-11",44,51,"11/6/1984",118,-7,40.6,58.8,-18.2
1984,"1984-07-12",43,44,"11/6/1984",117,-1,40.6,58.8,-18.2
1984,"1984-07-12",38,53,"11/6/1984",117,-15,40.6,58.8,-18.2
1984,"1984-07-13",43,49,"11/6/1984",116,-6,40.6,58.8,-18.2
1984,"1984-07-20",48,46,"11/6/1984",109,2,40.6,58.8,-18.2
1984,"1984-07-24",48,50,"11/6/1984",105,-2,40.6,58.8,-18.2
1984,"1984-08-09",38,54,"11/6/1984",89,-16,40.6,58.8,-18.2
1984,"1984-08-09",42,54,"11/6/1984",89,-12,40.6,58.8,-18.2
1984,"1984-08-09",39,54,"11/6/1984",89,-15,40.6,58.8,-18.2
1984,"1984-08-14",35,58,"11/6/1984",84,-23,40.6,58.8,-18.2
1984,"1984-08-16",41,52,"11/6/1984",82,-11,40.6,58.8,-18.2
1984,"1984-08-25",40,55,"11/6/1984",73,-15,40.6,58.8,-18.2
1984,"1984-08-30",33,60,"11/6/1984",68,-27,40.6,58.8,-18.2
1984,"1984-09-07",35,57,"11/6/1984",60,-22,40.6,58.8,-18.2
1984,"1984-09-09",42,55,"11/6/1984",58,-13,40.6,58.8,-18.2
1984,"1984-09-09",39,57,"11/6/1984",58,-18,40.6,58.8,-18.2
1984,"1984-09-09",40,55,"11/6/1984",58,-15,40.6,58.8,-18.2
1984,"1984-09-11",40,56,"11/6/1984",56,-16,40.6,58.8,-18.2
1984,"1984-09-11",32,62,"11/6/1984",56,-30,40.6,58.8,-18.2
1984,"1984-09-16",30,44,"11/6/1984",51,-14,40.6,58.8,-18.2
1984,"1984-09-16",35,60,"11/6/1984",51,-25,40.6,58.8,-18.2
1984,"1984-09-16",35,57,"11/6/1984",51,-22,40.6,58.8,-18.2
1984,"1984-09-23",39,57,"11/6/1984",44,-18,40.6,58.8,-18.2
1984,"1984-09-25",42,44,"11/6/1984",42,-2,40.6,58.8,-18.2
1984,"1984-09-30",39,56,"11/6/1984",37,-17,40.6,58.8,-18.2
1984,"1984-10-02",37,55,"11/6/1984",35,-18,40.6,58.8,-18.2
1984,"1984-10-03",33,59,"11/6/1984",34,-26,40.6,58.8,-18.2
1984,"1984-10-03",37,55,"11/6/1984",34,-18,40.6,58.8,-18.2
1984,"1984-10-09",41,56,"11/6/1984",28,-15,40.6,58.8,-18.2
1984,"1984-10-10",38,58,"11/6/1984",27,-20,40.6,58.8,-18.2
1984,"1984-10-14",44,53,"11/6/1984",23,-9,40.6,58.8,-18.2
1984,"1984-10-16",42,54,"11/6/1984",21,-12,40.6,58.8,-18.2
1984,"1984-10-16",35,60,"11/6/1984",21,-25,40.6,58.8,-18.2
1984,"1984-10-17",41,54,"11/6/1984",20,-13,40.6,58.8,-18.2
1984,"1984-10-18",36,61,"11/6/1984",19,-25,40.6,58.8,-18.2
1984,"1984-10-21",37,54,"11/6/1984",16,-17,40.6,58.8,-18.2
1984,"1984-10-23",34,40,"11/6/1984",14,-6,40.6,58.8,-18.2
1984,"1984-10-23",42,54,"11/6/1984",14,-12,40.6,58.8,-18.2
1984,"1984-10-23",42,56,"11/6/1984",14,-14,40.6,58.8,-18.2
1984,"1984-10-25",37,56,"11/6/1984",12,-19,40.6,58.8,-18.2
1984,"1984-10-26",30,54,"11/6/1984",11,-24,40.6,58.8,-18.2
1984,"1984-10-27",36,59,"11/6/1984",10,-23,40.6,58.8,-18.2
1984,"1984-10-28",41,58,"11/6/1984",9,-17,40.6,58.8,-18.2
1984,"1984-11-01",39,57,"11/6/1984",5,-18,40.6,58.8,-18.2
1984,"1984-11-03",42.5,52.5,"11/6/1984",3,-10,40.6,58.8,-18.2
1984,"1984-11-03",37,58,"11/6/1984",3,-21,40.6,58.8,-18.2
1984,"1984-11-03",43,55,"11/6/1984",3,-12,40.6,58.8,-18.2
1984,"1984-11-04",35,60,"11/6/1984",2,-25,40.6,58.8,-18.2
1984,"1984-11-04",44,56,"11/6/1984",2,-12,40.6,58.8,-18.2
1988,"1987-09-23",32,59,"11/8/1988",412,-27,45.6,53.4,-7.8
1988,"1988-02-16",40,52,"11/8/1988",266,-12,45.6,53.4,-7.8
1988,"1988-03-09",38,44,"11/8/1988",244,-6,45.6,53.4,-7.8
1988,"1988-03-11",43,49,"11/8/1988",242,-6,45.6,53.4,-7.8
1988,"1988-03-21",50,45,"11/8/1988",232,5,45.6,53.4,-7.8
1988,"1988-03-21",50,45,"11/8/1988",232,5,45.6,53.4,-7.8
1988,"1988-03-22",45,46,"11/8/1988",231,-1,45.6,53.4,-7.8
1988,"1988-03-31",43,44,"11/8/1988",222,-1,45.6,53.4,-7.8
1988,"1988-04-07",48,43,"11/8/1988",215,5,45.6,53.4,-7.8
1988,"1988-04-21",45,43,"11/8/1988",201,2,45.6,53.4,-7.8
1988,"1988-04-21",50,39,"11/8/1988",201,11,45.6,53.4,-7.8
1988,"1988-04-23",43,45,"11/8/1988",199,-2,45.6,53.4,-7.8
1988,"1988-05-02",50,43,"11/8/1988",190,7,45.6,53.4,-7.8
1988,"1988-05-10",50,43,"11/8/1988",182,7,45.6,53.4,-7.8
1988,"1988-05-12",49,39,"11/8/1988",180,10,45.6,53.4,-7.8
1988,"1988-05-15",54,38,"11/8/1988",177,16,45.6,53.4,-7.8
1988,"1988-05-16",52,41,"11/8/1988",176,11,45.6,53.4,-7.8
1988,"1988-05-22",53,40,"11/8/1988",170,13,45.6,53.4,-7.8
1988,"1988-05-25",53,40,"11/8/1988",167,13,45.6,53.4,-7.8
1988,"1988-05-26",53,40,"11/8/1988",166,13,45.6,53.4,-7.8
1988,"1988-06-08",49,44,"11/8/1988",153,5,45.6,53.4,-7.8
1988,"1988-06-09",45,38,"11/8/1988",152,7,45.6,53.4,-7.8
1988,"1988-06-12",49,34,"11/8/1988",149,15,45.6,53.4,-7.8
1988,"1988-06-12",49,36,"11/8/1988",149,13,45.6,53.4,-7.8
1988,"1988-06-12",52,38,"11/8/1988",149,14,45.6,53.4,-7.8
1988,"1988-06-19",51,39,"11/8/1988",142,12,45.6,53.4,-7.8
1988,"1988-06-26",45,42,"11/8/1988",135,3,45.6,53.4,-7.8
1988,"1988-06-26",46,41,"11/8/1988",135,5,45.6,53.4,-7.8
1988,"1988-07-08",47,39,"11/8/1988",123,8,45.6,53.4,-7.8
1988,"1988-07-10",49,38,"11/8/1988",121,11,45.6,53.4,-7.8
1988,"1988-07-10",44,47,"11/8/1988",121,-3,45.6,53.4,-7.8
1988,"1988-07-10",47,41,"11/8/1988",121,6,45.6,53.4,-7.8
1988,"1988-07-11",48,36,"11/8/1988",120,12,45.6,53.4,-7.8
1988,"1988-07-11",48,42,"11/8/1988",120,6,45.6,53.4,-7.8
1988,"1988-07-17",45,46,"11/8/1988",114,-1,45.6,53.4,-7.8
1988,"1988-07-20",53,41,"11/8/1988",111,12,45.6,53.4,-7.8
1988,"1988-07-22",55,38,"11/8/1988",109,17,45.6,53.4,-7.8
1988,"1988-07-24",54,37,"11/8/1988",107,17,45.6,53.4,-7.8
1988,"1988-07-25",57,39,"11/8/1988",106,18,45.6,53.4,-7.8
1988,"1988-07-25",50,32,"11/8/1988",106,18,45.6,53.4,-7.8
1988,"1988-07-25",51,34,"11/8/1988",106,17,45.6,53.4,-7.8
1988,"1988-08-03",50,33,"11/8/1988",97,17,45.6,53.4,-7.8
1988,"1988-08-07",49,42,"11/8/1988",93,7,45.6,53.4,-7.8
1988,"1988-08-08",52,39,"11/8/1988",92,13,45.6,53.4,-7.8
1988,"1988-08-08",50,36,"11/8/1988",92,14,45.6,53.4,-7.8
1988,"1988-08-08",49,39,"11/8/1988",92,10,45.6,53.4,-7.8
1988,"1988-08-08",52,40,"11/8/1988",92,12,45.6,53.4,-7.8
1988,"1988-08-09",51,45,"11/8/1988",91,6,45.6,53.4,-7.8
1988,"1988-08-09",51,45,"11/8/1988",91,6,45.6,53.4,-7.8
1988,"1988-08-10",46,49,"11/8/1988",90,-3,45.6,53.4,-7.8
1988,"1988-08-13",45,44,"11/8/1988",87,1,45.6,53.4,-7.8
1988,"1988-08-14",55,40,"11/8/1988",86,15,45.6,53.4,-7.8
1988,"1988-08-15",42,40,"11/8/1988",85,2,45.6,53.4,-7.8
1988,"1988-08-16",49,46,"11/8/1988",84,3,45.6,53.4,-7.8
1988,"1988-08-16",42,40,"11/8/1988",84,2,45.6,53.4,-7.8
1988,"1988-08-17",39,44,"11/8/1988",83,-5,45.6,53.4,-7.8
1988,"1988-08-18",44,45,"11/8/1988",82,-1,45.6,53.4,-7.8
1988,"1988-08-18",40,41,"11/8/1988",82,-1,45.6,53.4,-7.8
1988,"1988-08-18",46,45,"11/8/1988",82,1,45.6,53.4,-7.8
1988,"1988-08-19",42,51,"11/8/1988",81,-9,45.6,53.4,-7.8
1988,"1988-08-20",42,47,"11/8/1988",80,-5,45.6,53.4,-7.8
1988,"1988-08-21",44,48,"11/8/1988",79,-4,45.6,53.4,-7.8
1988,"1988-08-21",40,46,"11/8/1988",79,-6,45.6,53.4,-7.8
1988,"1988-08-22",47,49,"11/8/1988",78,-2,45.6,53.4,-7.8
1988,"1988-08-22",39,44,"11/8/1988",78,-5,45.6,53.4,-7.8
1988,"1988-08-22",40,47,"11/8/1988",78,-7,45.6,53.4,-7.8
1988,"1988-08-23",46,48,"11/8/1988",77,-2,45.6,53.4,-7.8
1988,"1988-08-25",46,48,"11/8/1988",75,-2,45.6,53.4,-7.8
1988,"1988-08-30",48,47,"11/8/1988",70,1,45.6,53.4,-7.8
1988,"1988-08-30",42,47,"11/8/1988",70,-5,45.6,53.4,-7.8
1988,"1988-09-06",43,51,"11/8/1988",63,-8,45.6,53.4,-7.8
1988,"1988-09-06",44,50,"11/8/1988",63,-6,45.6,53.4,-7.8
1988,"1988-09-08",46,48,"11/8/1988",61,-2,45.6,53.4,-7.8
1988,"1988-09-11",39,47,"11/8/1988",58,-8,45.6,53.4,-7.8
1988,"1988-09-11",41,49,"11/8/1988",58,-8,45.6,53.4,-7.8
1988,"1988-09-11",41,49,"11/8/1988",58,-8,45.6,53.4,-7.8
1988,"1988-09-11",47,47,"11/8/1988",58,0,45.6,53.4,-7.8
1988,"1988-09-13",48,45,"11/8/1988",56,3,45.6,53.4,-7.8
1988,"1988-09-14",44,50,"11/8/1988",55,-6,45.6,53.4,-7.8
1988,"1988-09-19",46,50,"11/8/1988",50,-4,45.6,53.4,-7.8
1988,"1988-09-20",41,45,"11/8/1988",49,-4,45.6,53.4,-7.8
1988,"1988-09-23",44,49,"11/8/1988",46,-5,45.6,53.4,-7.8
1988,"1988-09-27",46,49,"11/8/1988",42,-3,45.6,53.4,-7.8
1988,"1988-09-28",42,47,"11/8/1988",41,-5,45.6,53.4,-7.8
1988,"1988-09-28",41,48,"11/8/1988",41,-7,45.6,53.4,-7.8
1988,"1988-10-03",46,48,"11/8/1988",36,-2,45.6,53.4,-7.8
1988,"1988-10-04",44,51,"11/8/1988",35,-7,45.6,53.4,-7.8
1988,"1988-10-09",39,48,"11/8/1988",30,-9,45.6,53.4,-7.8
1988,"1988-10-10",47,50,"11/8/1988",29,-3,45.6,53.4,-7.8
1988,"1988-10-10",45,48,"11/8/1988",29,-3,45.6,53.4,-7.8
1988,"1988-10-10",45,50,"11/8/1988",29,-5,45.6,53.4,-7.8
1988,"1988-10-11",45,51,"11/8/1988",28,-6,45.6,53.4,-7.8
1988,"1988-10-13",40,48,"11/8/1988",26,-8,45.6,53.4,-7.8
1988,"1988-10-14",39,47,"11/8/1988",25,-8,45.6,53.4,-7.8
1988,"1988-10-15",39,48,"11/8/1988",24,-9,45.6,53.4,-7.8
1988,"1988-10-16",40,47,"11/8/1988",23,-7,45.6,53.4,-7.8
1988,"1988-10-16",38,55,"11/8/1988",23,-17,45.6,53.4,-7.8
1988,"1988-10-16",38,55,"11/8/1988",23,-17,45.6,53.4,-7.8
1988,"1988-10-17",44,53,"11/8/1988",22,-9,45.6,53.4,-7.8
1988,"1988-10-17",39,49,"11/8/1988",22,-10,45.6,53.4,-7.8
1988,"1988-10-18",45,52,"11/8/1988",21,-7,45.6,53.4,-7.8
1988,"1988-10-18",39,49,"11/8/1988",21,-10,45.6,53.4,-7.8
1988,"1988-10-19",39,50,"11/8/1988",20,-11,45.6,53.4,-7.8
1988,"1988-10-20",38,51,"11/8/1988",19,-13,45.6,53.4,-7.8
1988,"1988-10-21",39,52,"11/8/1988",18,-13,45.6,53.4,-7.8
1988,"1988-10-21",41,50,"11/8/1988",18,-9,45.6,53.4,-7.8
1988,"1988-10-22",38,51,"11/8/1988",17,-13,45.6,53.4,-7.8
1988,"1988-10-23",40,50,"11/8/1988",16,-10,45.6,53.4,-7.8
1988,"1988-10-23",40,50,"11/8/1988",16,-10,45.6,53.4,-7.8
1988,"1988-10-23",39,53,"11/8/1988",16,-14,45.6,53.4,-7.8
1988,"1988-10-24",41,54,"11/8/1988",15,-13,45.6,53.4,-7.8
1988,"1988-10-24",40,51,"11/8/1988",15,-11,45.6,53.4,-7.8
1988,"1988-10-25",39,50,"11/8/1988",14,-11,45.6,53.4,-7.8
1988,"1988-10-26",41,52,"11/8/1988",13,-11,45.6,53.4,-7.8
1988,"1988-10-26",42,51,"11/8/1988",13,-9,45.6,53.4,-7.8
1988,"1988-10-26",37,49,"11/8/1988",13,-12,45.6,53.4,-7.8
1988,"1988-10-26",41,54,"11/8/1988",13,-13,45.6,53.4,-7.8
1988,"1988-10-26",40,50,"11/8/1988",13,-10,45.6,53.4,-7.8
1988,"1988-10-27",36,49,"11/8/1988",12,-13,45.6,53.4,-7.8
1988,"1988-10-28",37,49,"11/8/1988",11,-12,45.6,53.4,-7.8
1988,"1988-10-29",36,50,"11/8/1988",10,-14,45.6,53.4,-7.8
1988,"1988-10-30",38,49,"11/8/1988",9,-11,45.6,53.4,-7.8
1988,"1988-10-30",45,52,"11/8/1988",9,-7,45.6,53.4,-7.8
1988,"1988-10-31",42,55,"11/8/1988",8,-13,45.6,53.4,-7.8
1988,"1988-10-31",39,48,"11/8/1988",8,-9,45.6,53.4,-7.8
1988,"1988-10-31",41,53,"11/8/1988",8,-12,45.6,53.4,-7.8
1988,"1988-11-01",40,48,"11/8/1988",7,-8,45.6,53.4,-7.8
1988,"1988-11-02",39,47,"11/8/1988",6,-8,45.6,53.4,-7.8
1988,"1988-11-02",41,47,"11/8/1988",6,-6,45.6,53.4,-7.8
1988,"1988-11-03",40,48,"11/8/1988",5,-8,45.6,53.4,-7.8
1988,"1988-11-03",41,48,"11/8/1988",5,-7,45.6,53.4,-7.8
1988,"1988-11-03",41,53,"11/8/1988",5,-12,45.6,53.4,-7.8
1988,"1988-11-04",39,48,"11/8/1988",4,-9,45.6,53.4,-7.8
1988,"1988-11-04",40,47,"11/8/1988",4,-7,45.6,53.4,-7.8
1988,"1988-11-04",43,52,"11/8/1988",4,-9,45.6,53.4,-7.8
1988,"1988-11-05",43,48,"11/8/1988",3,-5,45.6,53.4,-7.8
1988,"1988-11-05",45,50,"11/8/1988",3,-5,45.6,53.4,-7.8
1988,"1988-11-05",44,54,"11/8/1988",3,-10,45.6,53.4,-7.8
1988,"1988-11-05",40,49,"11/8/1988",3,-9,45.6,53.4,-7.8
1988,"1988-11-05",42,48,"11/8/1988",3,-6,45.6,53.4,-7.8
1988,"1988-11-05",41,53,"11/8/1988",3,-12,45.6,53.4,-7.8
1988,"1988-11-05",42,51,"11/8/1988",3,-9,45.6,53.4,-7.8
1988,"1988-11-06",35,54,"11/8/1988",2,-19,45.6,53.4,-7.8
1988,"1988-11-06",42,52,"11/8/1988",2,-10,45.6,53.4,-7.8
1988,"1988-11-06",42,53,"11/8/1988",2,-11,45.6,53.4,-7.8
1988,"1988-11-06",40,49,"11/8/1988",2,-9,45.6,53.4,-7.8
1988,"1988-11-06",42,47,"11/8/1988",2,-5,45.6,53.4,-7.8
1988,"1988-11-07",47,51,"11/8/1988",1,-4,45.6,53.4,-7.8
1988,"1988-11-07",42,48,"11/8/1988",1,-6,45.6,53.4,-7.8
1988,"1988-11-07",43,48,"11/8/1988",1,-5,45.6,53.4,-7.8
1988,"1988-11-07",43,52,"11/8/1988",1,-9,45.6,53.4,-7.8
1988,"1987-12-16",30,48,"11/8/1988",328,-18,45.6,53.4,-7.8
1992,"1991-10-29",20,55,"11/3/1992",371,-35,43,37.4,5.6
1992,"1991-12-13",22,47,"11/3/1992",326,-25,43,37.4,5.6
1992,"1991-12-22",29,50,"11/3/1992",317,-21,43,37.4,5.6
1992,"1992-01-02",30,52,"11/3/1992",306,-22,43,37.4,5.6
1992,"1992-01-16",31,47,"11/3/1992",292,-16,43,37.4,5.6
1992,"1992-01-21",22,52,"11/3/1992",287,-30,43,37.4,5.6
1992,"1992-01-27",38,51,"11/3/1992",281,-13,43,37.4,5.6
1992,"1992-02-03",40,51,"11/3/1992",274,-11,43,37.4,5.6
1992,"1992-02-09",38,53,"11/3/1992",268,-15,43,37.4,5.6
1992,"1992-02-20",40,51,"11/3/1992",257,-11,43,37.4,5.6
1992,"1992-02-20",43,53,"11/3/1992",257,-10,43,37.4,5.6
1992,"1992-02-20",38,46,"11/3/1992",257,-8,43,37.4,5.6
1992,"1992-03-01",40,50,"11/3/1992",247,-10,43,37.4,5.6
1992,"1992-03-02",39,51,"11/3/1992",246,-12,43,37.4,5.6
1992,"1992-03-08",44,46,"11/3/1992",240,-2,43,37.4,5.6
1992,"1992-03-08",46,44,"11/3/1992",240,2,43,37.4,5.6
1992,"1992-03-12",44,50,"11/3/1992",236,-6,43,37.4,5.6
1992,"1992-03-12",43,43,"11/3/1992",236,0,43,37.4,5.6
1992,"1992-03-20",44,48,"11/3/1992",228,-4,43,37.4,5.6
1992,"1992-03-22",43,52,"11/3/1992",226,-9,43,37.4,5.6
1992,"1992-03-29",38,54,"11/3/1992",219,-16,43,37.4,5.6
1992,"1992-03-29",43,50,"11/3/1992",219,-7,43,37.4,5.6
1992,"1992-03-29",40,49,"11/3/1992",219,-9,43,37.4,5.6
1992,"1992-03-29",31,44,"11/3/1992",219,-13,43,37.4,5.6
1992,"1992-03-29",46,48,"11/3/1992",219,-2,43,37.4,5.6
1992,"1992-03-29",35,37,"11/3/1992",219,-2,43,37.4,5.6
1992,"1992-04-01",34,54,"11/3/1992",216,-20,43,37.4,5.6
1992,"1992-04-01",25,44,"11/3/1992",216,-19,43,37.4,5.6
1992,"1992-04-02",25,44,"11/3/1992",215,-19,43,37.4,5.6
1992,"1992-04-09",38,43,"11/3/1992",208,-5,43,37.4,5.6
1992,"1992-04-09",40,42,"11/3/1992",208,-2,43,37.4,5.6
1992,"1992-04-09",28,38,"11/3/1992",208,-10,43,37.4,5.6
1992,"1992-04-10",33,44,"11/3/1992",207,-11,43,37.4,5.6
1992,"1992-04-10",25,40,"11/3/1992",207,-15,43,37.4,5.6
1992,"1992-04-12",41,48,"11/3/1992",205,-7,43,37.4,5.6
1992,"1992-04-14",24,37,"11/3/1992",203,-13,43,37.4,5.6
1992,"1992-04-14",30,38,"11/3/1992",203,-8,43,37.4,5.6
1992,"1992-04-14",42,50,"11/3/1992",203,-8,43,37.4,5.6
1992,"1992-04-15",29,40,"11/3/1992",202,-11,43,37.4,5.6
1992,"1992-04-16",27,42,"11/3/1992",201,-15,43,37.4,5.6
1992,"1992-04-22",34,50,"11/3/1992",195,-16,43,37.4,5.6
1992,"1992-04-22",26,41,"11/3/1992",195,-15,43,37.4,5.6
1992,"1992-04-23",41,48,"11/3/1992",194,-7,43,37.4,5.6
1992,"1992-04-23",28,38,"11/3/1992",194,-10,43,37.4,5.6
1992,"1992-04-25",30,41,"11/3/1992",192,-11,43,37.4,5.6
1992,"1992-04-25",23,32,"11/3/1992",192,-9,43,37.4,5.6
1992,"1992-04-26",42,49,"11/3/1992",191,-7,43,37.4,5.6
1992,"1992-04-26",31,38,"11/3/1992",191,-7,43,37.4,5.6
1992,"1992-04-26",44,48,"11/3/1992",191,-4,43,37.4,5.6
1992,"1992-04-26",31,36,"11/3/1992",191,-5,43,37.4,5.6
1992,"1992-05-01",27,38,"11/3/1992",186,-11,43,37.4,5.6
1992,"1992-05-03",30,33,"11/3/1992",184,-3,43,37.4,5.6
1992,"1992-05-03",43,46,"11/3/1992",184,-3,43,37.4,5.6
1992,"1992-05-07",26,43,"11/3/1992",180,-17,43,37.4,5.6
1992,"1992-05-08",43,49,"11/3/1992",179,-6,43,37.4,5.6
1992,"1992-05-08",30,36,"11/3/1992",179,-6,43,37.4,5.6
1992,"1992-05-10",40,45,"11/3/1992",177,-5,43,37.4,5.6
1992,"1992-05-10",29,35,"11/3/1992",177,-6,43,37.4,5.6
1992,"1992-05-12",29,33,"11/3/1992",175,-4,43,37.4,5.6
1992,"1992-05-14",35,38,"11/3/1992",173,-3,43,37.4,5.6
1992,"1992-05-14",24,28,"11/3/1992",173,-4,43,37.4,5.6
1992,"1992-05-19",27,35,"11/3/1992",168,-8,43,37.4,5.6
1992,"1992-05-19",43,47,"11/3/1992",168,-4,43,37.4,5.6
1992,"1992-05-20",39,50,"11/3/1992",167,-11,43,37.4,5.6
1992,"1992-05-20",25,35,"11/3/1992",167,-10,43,37.4,5.6
1992,"1992-05-22",24,36,"11/3/1992",165,-12,43,37.4,5.6
1992,"1992-05-30",41,48,"11/3/1992",157,-7,43,37.4,5.6
1992,"1992-05-30",27,35,"11/3/1992",157,-8,43,37.4,5.6
1992,"1992-05-31",27,31,"11/3/1992",156,-4,43,37.4,5.6
1992,"1992-05-31",29,31,"11/3/1992",156,-2,43,37.4,5.6
1992,"1992-05-31",29,29,"11/3/1992",156,0,43,37.4,5.6
1992,"1992-05-31",45,41,"11/3/1992",156,4,43,37.4,5.6
1992,"1992-05-31",43,43,"11/3/1992",156,0,43,37.4,5.6
1992,"1992-05-31",46,43,"11/3/1992",156,3,43,37.4,5.6
1992,"1992-06-04",38,48,"11/3/1992",152,-10,43,37.4,5.6
1992,"1992-06-04",24,32,"11/3/1992",152,-8,43,37.4,5.6
1992,"1992-06-04",38,35,"11/3/1992",152,3,43,37.4,5.6
1992,"1992-06-04",24,24,"11/3/1992",152,0,43,37.4,5.6
1992,"1992-06-05",25,33,"11/3/1992",151,-8,43,37.4,5.6
1992,"1992-06-07",25,30,"11/3/1992",149,-5,43,37.4,5.6
1992,"1992-06-07",26,30,"11/3/1992",149,-4,43,37.4,5.6
1992,"1992-06-07",26,30,"11/3/1992",149,-4,43,37.4,5.6
1992,"1992-06-08",25,31,"11/3/1992",148,-6,43,37.4,5.6
1992,"1992-06-08",40,46,"11/3/1992",148,-6,43,37.4,5.6
1992,"1992-06-10",27,31,"11/3/1992",146,-4,43,37.4,5.6
1992,"1992-06-10",41,46,"11/3/1992",146,-5,43,37.4,5.6
1992,"1992-06-10",27,35,"11/3/1992",146,-8,43,37.4,5.6
1992,"1992-06-10",41,39,"11/3/1992",146,2,43,37.4,5.6
1992,"1992-06-10",25,33,"11/3/1992",146,-8,43,37.4,5.6
1992,"1992-06-10",25,34,"11/3/1992",146,-9,43,37.4,5.6
1992,"1992-06-14",24,32,"11/3/1992",142,-8,43,37.4,5.6
1992,"1992-06-20",40,45,"11/3/1992",136,-5,43,37.4,5.6
1992,"1992-06-20",26,34,"11/3/1992",136,-8,43,37.4,5.6
1992,"1992-06-28",31,29,"11/3/1992",128,2,43,37.4,5.6
1992,"1992-06-28",33,28,"11/3/1992",128,5,43,37.4,5.6
1992,"1992-06-28",33,29,"11/3/1992",128,4,43,37.4,5.6
1992,"1992-06-29",41,44,"11/3/1992",127,-3,43,37.4,5.6
1992,"1992-06-29",27,33,"11/3/1992",127,-6,43,37.4,5.6
1992,"1992-07-07",28,31,"11/3/1992",119,-3,43,37.4,5.6
1992,"1992-07-08",30,33,"11/3/1992",118,-3,43,37.4,5.6
1992,"1992-07-08",30,34,"11/3/1992",118,-4,43,37.4,5.6
1992,"1992-07-08",30,35,"11/3/1992",118,-5,43,37.4,5.6
1992,"1992-07-08",40,48,"11/3/1992",118,-8,43,37.4,5.6
1992,"1992-07-08",44,45,"11/3/1992",118,-1,43,37.4,5.6
1992,"1992-07-08",44,47,"11/3/1992",118,-3,43,37.4,5.6
1992,"1992-07-09",29,28,"11/3/1992",117,1,43,37.4,5.6
1992,"1992-07-09",48,42,"11/3/1992",117,6,43,37.4,5.6
1992,"1992-07-09",39,37,"11/3/1992",117,2,43,37.4,5.6
1992,"1992-07-09",28,26,"11/3/1992",117,2,43,37.4,5.6
1992,"1992-07-10",31,32,"11/3/1992",116,-1,43,37.4,5.6
1992,"1992-07-11",32,36,"11/3/1992",115,-4,43,37.4,5.6
1992,"1992-07-13",44,40,"11/3/1992",113,4,43,37.4,5.6
1992,"1992-07-13",35,31,"11/3/1992",113,4,43,37.4,5.6
1992,"1992-07-14",47,33,"11/3/1992",112,14,43,37.4,5.6
1992,"1992-07-14",50,32,"11/3/1992",112,18,43,37.4,5.6
1992,"1992-07-14",47,39,"11/3/1992",112,8,43,37.4,5.6
1992,"1992-07-14",40,31,"11/3/1992",112,9,43,37.4,5.6
1992,"1992-07-15",39,35,"11/3/1992",111,4,43,37.4,5.6
1992,"1992-07-15",32,36,"11/3/1992",111,-4,43,37.4,5.6
1992,"1992-07-15",48,38,"11/3/1992",111,10,43,37.4,5.6
1992,"1992-07-15",41,30,"11/3/1992",111,11,43,37.4,5.6
1992,"1992-07-16",49,29,"11/3/1992",110,20,43,37.4,5.6
1992,"1992-07-16",54,31,"11/3/1992",110,23,43,37.4,5.6
1992,"1992-07-16",40,20,"11/3/1992",110,20,43,37.4,5.6
1992,"1992-07-16",43,19,"11/3/1992",110,24,43,37.4,5.6
1992,"1992-07-16",58,29,"11/3/1992",110,29,43,37.4,5.6
1992,"1992-07-16",56,33,"11/3/1992",110,23,43,37.4,5.6
1992,"1992-07-17",41,25,"11/3/1992",109,16,43,37.4,5.6
1992,"1992-07-17",58,35,"11/3/1992",109,23,43,37.4,5.6
1992,"1992-07-17",52,32,"11/3/1992",109,20,43,37.4,5.6
1992,"1992-07-17",59,32,"11/3/1992",109,27,43,37.4,5.6
1992,"1992-07-18",56,34,"11/3/1992",108,22,43,37.4,5.6
1992,"1992-07-19",58,29,"11/3/1992",107,29,43,37.4,5.6
1992,"1992-07-19",39,22,"11/3/1992",107,17,43,37.4,5.6
1992,"1992-07-19",58,30,"11/3/1992",107,28,43,37.4,5.6
1992,"1992-07-19",39,22,"11/3/1992",107,17,43,37.4,5.6
1992,"1992-07-19",58,29,"11/3/1992",107,29,43,37.4,5.6
1992,"1992-07-19",63,33,"11/3/1992",107,30,43,37.4,5.6
1992,"1992-07-19",58,30,"11/3/1992",107,28,43,37.4,5.6
1992,"1992-07-23",53,26,"11/3/1992",103,27,43,37.4,5.6
1992,"1992-07-23",44,22,"11/3/1992",103,22,43,37.4,5.6
1992,"1992-07-24",55,37,"11/3/1992",102,18,43,37.4,5.6
1992,"1992-07-26",58,31,"11/3/1992",100,27,43,37.4,5.6
1992,"1992-07-26",56,36,"11/3/1992",100,20,43,37.4,5.6
1992,"1992-08-01",57,32,"11/3/1992",94,25,43,37.4,5.6
1992,"1992-08-02",57,32,"11/3/1992",93,25,43,37.4,5.6
1992,"1992-08-05",56,32,"11/3/1992",90,24,43,37.4,5.6
1992,"1992-08-07",54,37,"11/3/1992",88,17,43,37.4,5.6
1992,"1992-08-09",58,37,"11/3/1992",86,21,43,37.4,5.6
1992,"1992-08-11",43,25,"11/3/1992",84,18,43,37.4,5.6
1992,"1992-08-11",60,34,"11/3/1992",84,26,43,37.4,5.6
1992,"1992-08-11",61,35,"11/3/1992",84,26,43,37.4,5.6
1992,"1992-08-12",40,26,"11/3/1992",83,14,43,37.4,5.6
1992,"1992-08-12",54,36,"11/3/1992",83,18,43,37.4,5.6
1992,"1992-08-12",56,37,"11/3/1992",83,19,43,37.4,5.6
1992,"1992-08-14",55,37,"11/3/1992",81,18,43,37.4,5.6
1992,"1992-08-14",45,32,"11/3/1992",81,13,43,37.4,5.6
1992,"1992-08-14",56,33,"11/3/1992",81,23,43,37.4,5.6
1992,"1992-08-14",53,36,"11/3/1992",81,17,43,37.4,5.6
1992,"1992-08-16",57,37,"11/3/1992",79,20,43,37.4,5.6
1992,"1992-08-16",44,28,"11/3/1992",79,16,43,37.4,5.6
1992,"1992-08-16",58,33,"11/3/1992",79,25,43,37.4,5.6
1992,"1992-08-17",51,35,"11/3/1992",78,16,43,37.4,5.6
1992,"1992-08-18",57,32,"11/3/1992",77,25,43,37.4,5.6
1992,"1992-08-18",57,32,"11/3/1992",77,25,43,37.4,5.6
1992,"1992-08-18",58,33,"11/3/1992",77,25,43,37.4,5.6
1992,"1992-08-18",50,39,"11/3/1992",77,11,43,37.4,5.6
1992,"1992-08-19",51,40,"11/3/1992",76,11,43,37.4,5.6
1992,"1992-08-19",48,43,"11/3/1992",76,5,43,37.4,5.6
1992,"1992-08-20",49,38,"11/3/1992",75,11,43,37.4,5.6
1992,"1992-08-20",50,41,"11/3/1992",75,9,43,37.4,5.6
1992,"1992-08-20",51,39,"11/3/1992",75,12,43,37.4,5.6
1992,"1992-08-20",47,36,"11/3/1992",75,11,43,37.4,5.6
1992,"1992-08-20",39,30,"11/3/1992",75,9,43,37.4,5.6
1992,"1992-08-20",48,46,"11/3/1992",75,2,43,37.4,5.6
1992,"1992-08-20",50,41,"11/3/1992",75,9,43,37.4,5.6
1992,"1992-08-21",49,40,"11/3/1992",74,9,43,37.4,5.6
1992,"1992-08-21",49,41,"11/3/1992",74,8,43,37.4,5.6
1992,"1992-08-21",53,39,"11/3/1992",74,14,43,37.4,5.6
1992,"1992-08-23",47,42,"11/3/1992",72,5,43,37.4,5.6
1992,"1992-08-23",48,42,"11/3/1992",72,6,43,37.4,5.6
1992,"1992-08-23",52,42,"11/3/1992",72,10,43,37.4,5.6
1992,"1992-08-24",44,31,"11/3/1992",71,13,43,37.4,5.6
1992,"1992-08-24",55,39,"11/3/1992",71,16,43,37.4,5.6
1992,"1992-08-25",41,51,"11/3/1992",70,-10,43,37.4,5.6
1992,"1992-08-27",49,44,"11/3/1992",68,5,43,37.4,5.6
1992,"1992-08-28",49,39,"11/3/1992",67,10,43,37.4,5.6
1992,"1992-08-30",55,36,"11/3/1992",65,19,43,37.4,5.6
1992,"1992-08-30",56,36,"11/3/1992",65,20,43,37.4,5.6
1992,"1992-09-01",50,45,"11/3/1992",63,5,43,37.4,5.6
1992,"1992-09-02",54,39,"11/3/1992",62,15,43,37.4,5.6
1992,"1992-09-05",38,31,"11/3/1992",59,7,43,37.4,5.6
1992,"1992-09-05",49,40,"11/3/1992",59,9,43,37.4,5.6
1992,"1992-09-06",49,43,"11/3/1992",58,6,43,37.4,5.6
1992,"1992-09-06",53,38,"11/3/1992",58,15,43,37.4,5.6
1992,"1992-09-06",53,41,"11/3/1992",58,12,43,37.4,5.6
1992,"1992-09-06",49,43,"11/3/1992",58,6,43,37.4,5.6
1992,"1992-09-07",48,42,"11/3/1992",57,6,43,37.4,5.6
1992,"1992-09-08",50,40,"11/3/1992",56,10,43,37.4,5.6
1992,"1992-09-09",52,38,"11/3/1992",55,14,43,37.4,5.6
1992,"1992-09-10",50,39,"11/3/1992",54,11,43,37.4,5.6
1992,"1992-09-11",53,38,"11/3/1992",53,15,43,37.4,5.6
1992,"1992-09-13",51,39,"11/3/1992",51,12,43,37.4,5.6
1992,"1992-09-13",42,34,"11/3/1992",51,8,43,37.4,5.6
1992,"1992-09-13",54,38,"11/3/1992",51,16,43,37.4,5.6
1992,"1992-09-13",52,40,"11/3/1992",51,12,43,37.4,5.6
1992,"1992-09-13",54,39,"11/3/1992",51,15,43,37.4,5.6
1992,"1992-09-13",45,33,"11/3/1992",51,12,43,37.4,5.6
1992,"1992-09-13",53,38,"11/3/1992",51,15,43,37.4,5.6
1992,"1992-09-13",42,35,"11/3/1992",51,7,43,37.4,5.6
1992,"1992-09-13",52,40,"11/3/1992",51,12,43,37.4,5.6
1992,"1992-09-13",51,42,"11/3/1992",51,9,43,37.4,5.6
1992,"1992-09-14",51,39,"11/3/1992",50,12,43,37.4,5.6
1992,"1992-09-15",49,40,"11/3/1992",49,9,43,37.4,5.6
1992,"1992-09-15",39,33,"11/3/1992",49,6,43,37.4,5.6
1992,"1992-09-15",51,41,"11/3/1992",49,10,43,37.4,5.6
1992,"1992-09-16",49,40,"11/3/1992",48,9,43,37.4,5.6
1992,"1992-09-17",48,41,"11/3/1992",47,7,43,37.4,5.6
1992,"1992-09-20",47,41,"11/3/1992",44,6,43,37.4,5.6
1992,"1992-09-20",50,31,"11/3/1992",44,19,43,37.4,5.6
1992,"1992-09-20",58,37,"11/3/1992",44,21,43,37.4,5.6
1992,"1992-09-20",50,40,"11/3/1992",44,10,43,37.4,5.6
1992,"1992-09-21",48,39,"11/3/1992",43,9,43,37.4,5.6
1992,"1992-09-21",44,38,"11/3/1992",43,6,43,37.4,5.6
1992,"1992-09-22",48,39,"11/3/1992",42,9,43,37.4,5.6
1992,"1992-09-23",49,40,"11/3/1992",41,9,43,37.4,5.6
1992,"1992-09-23",53,38,"11/3/1992",41,15,43,37.4,5.6
1992,"1992-09-23",45,31,"11/3/1992",41,14,43,37.4,5.6
1992,"1992-09-24",48,41,"11/3/1992",40,7,43,37.4,5.6
1992,"1992-09-24",42,34,"11/3/1992",40,8,43,37.4,5.6
1992,"1992-09-24",49,37,"11/3/1992",40,12,43,37.4,5.6
1992,"1992-09-24",52,40,"11/3/1992",40,12,43,37.4,5.6
1992,"1992-09-24",43,32,"11/3/1992",40,11,43,37.4,5.6
1992,"1992-09-25",50,40,"11/3/1992",39,10,43,37.4,5.6
1992,"1992-09-25",46,37,"11/3/1992",39,9,43,37.4,5.6
1992,"1992-09-27",49,40,"11/3/1992",37,9,43,37.4,5.6
1992,"1992-09-27",51,42,"11/3/1992",37,9,43,37.4,5.6
1992,"1992-09-27",43,38,"11/3/1992",37,5,43,37.4,5.6
1992,"1992-09-27",44,39,"11/3/1992",37,5,43,37.4,5.6
1992,"1992-09-27",45,34,"11/3/1992",37,11,43,37.4,5.6
1992,"1992-09-27",53,40,"11/3/1992",37,13,43,37.4,5.6
1992,"1992-09-28",48,41,"11/3/1992",36,7,43,37.4,5.6
1992,"1992-09-28",45,38,"11/3/1992",36,7,43,37.4,5.6
1992,"1992-09-28",45,38,"11/3/1992",36,7,43,37.4,5.6
1992,"1992-09-29",48,39,"11/3/1992",35,9,43,37.4,5.6
1992,"1992-09-29",45,38,"11/3/1992",35,7,43,37.4,5.6
1992,"1992-09-30",49,38,"11/3/1992",34,11,43,37.4,5.6
1992,"1992-09-30",45,37,"11/3/1992",34,8,43,37.4,5.6
1992,"1992-09-30",54,38,"11/3/1992",34,16,43,37.4,5.6
1992,"1992-09-30",52,35,"11/3/1992",34,17,43,37.4,5.6
1992,"1992-10-01",45,37,"11/3/1992",33,8,43,37.4,5.6
1992,"1992-10-01",51,35,"11/3/1992",33,16,43,37.4,5.6
1992,"1992-10-02",49,36,"11/3/1992",32,13,43,37.4,5.6
1992,"1992-10-02",44,36,"11/3/1992",32,8,43,37.4,5.6
1992,"1992-10-03",47,35,"11/3/1992",31,12,43,37.4,5.6
1992,"1992-10-04",46,35,"11/3/1992",30,11,43,37.4,5.6
1992,"1992-10-04",46,35,"11/3/1992",30,11,43,37.4,5.6
1992,"1992-10-04",46,38,"11/3/1992",30,8,43,37.4,5.6
1992,"1992-10-04",47,35,"11/3/1992",30,12,43,37.4,5.6
1992,"1992-10-04",48,35,"11/3/1992",30,13,43,37.4,5.6
1992,"1992-10-04",47,41,"11/3/1992",30,6,43,37.4,5.6
1992,"1992-10-04",53,36,"11/3/1992",30,17,43,37.4,5.6
1992,"1992-10-04",48,35,"11/3/1992",30,13,43,37.4,5.6
1992,"1992-10-05",48,35,"11/3/1992",29,13,43,37.4,5.6
1992,"1992-10-05",48,34,"11/3/1992",29,14,43,37.4,5.6
1992,"1992-10-05",53,39,"11/3/1992",29,14,43,37.4,5.6
1992,"1992-10-05",46,36,"11/3/1992",29,10,43,37.4,5.6
1992,"1992-10-05",46,32,"11/3/1992",29,14,43,37.4,5.6
1992,"1992-10-06",48,36,"11/3/1992",28,12,43,37.4,5.6
1992,"1992-10-06",47,35,"11/3/1992",28,12,43,37.4,5.6
1992,"1992-10-07",49,35,"11/3/1992",27,14,43,37.4,5.6
1992,"1992-10-07",50,34,"11/3/1992",27,16,43,37.4,5.6
1992,"1992-10-08",49,34,"11/3/1992",26,15,43,37.4,5.6
1992,"1992-10-08",49,34,"11/3/1992",26,15,43,37.4,5.6
1992,"1992-10-08",48,36,"11/3/1992",26,12,43,37.4,5.6
1992,"1992-10-09",50,34,"11/3/1992",25,16,43,37.4,5.6
1992,"1992-10-09",44,35,"11/3/1992",25,9,43,37.4,5.6
1992,"1992-10-10",49,35,"11/3/1992",24,14,43,37.4,5.6
1992,"1992-10-10",51,33,"11/3/1992",24,18,43,37.4,5.6
1992,"1992-10-11",47,34,"11/3/1992",23,13,43,37.4,5.6
1992,"1992-10-11",50,33,"11/3/1992",23,17,43,37.4,5.6
1992,"1992-10-11",49,35,"11/3/1992",23,14,43,37.4,5.6
1992,"1992-10-12",45,34,"11/3/1992",22,11,43,37.4,5.6
1992,"1992-10-12",48,33,"11/3/1992",22,15,43,37.4,5.6
1992,"1992-10-12",46,34,"11/3/1992",22,12,43,37.4,5.6
1992,"1992-10-13",43,34,"11/3/1992",21,9,43,37.4,5.6
1992,"1992-10-13",46,34,"11/3/1992",21,12,43,37.4,5.6
1992,"1992-10-13",45,35,"11/3/1992",21,10,43,37.4,5.6
1992,"1992-10-14",41,35,"11/3/1992",20,6,43,37.4,5.6
1992,"1992-10-14",47,32,"11/3/1992",20,15,43,37.4,5.6
1992,"1992-10-14",44,37,"11/3/1992",20,7,43,37.4,5.6
1992,"1992-10-15",43,33,"11/3/1992",19,10,43,37.4,5.6
1992,"1992-10-15",47,34,"11/3/1992",19,13,43,37.4,5.6
1992,"1992-10-15",44,34,"11/3/1992",19,10,43,37.4,5.6
1992,"1992-10-16",39,33,"11/3/1992",18,6,43,37.4,5.6
1992,"1992-10-16",47,34,"11/3/1992",18,13,43,37.4,5.6
1992,"1992-10-16",46,31,"11/3/1992",18,15,43,37.4,5.6
1992,"1992-10-17",49,31,"11/3/1992",17,18,43,37.4,5.6
1992,"1992-10-17",46,34,"11/3/1992",17,12,43,37.4,5.6
1992,"1992-10-17",50,33,"11/3/1992",17,17,43,37.4,5.6
1992,"1992-10-18",45,32,"11/3/1992",16,13,43,37.4,5.6
1992,"1992-10-18",48,30,"11/3/1992",16,18,43,37.4,5.6
1992,"1992-10-18",49,30,"11/3/1992",16,19,43,37.4,5.6
1992,"1992-10-19",45,33,"11/3/1992",15,12,43,37.4,5.6
1992,"1992-10-19",47,29,"11/3/1992",15,18,43,37.4,5.6
1992,"1992-10-19",46,30,"11/3/1992",15,16,43,37.4,5.6
1992,"1992-10-20",46,32,"11/3/1992",14,14,43,37.4,5.6
1992,"1992-10-20",45,32,"11/3/1992",14,13,43,37.4,5.6
1992,"1992-10-20",44,32,"11/3/1992",14,12,43,37.4,5.6
1992,"1992-10-21",46,31,"11/3/1992",13,15,43,37.4,5.6
1992,"1992-10-21",44,32,"11/3/1992",13,12,43,37.4,5.6
1992,"1992-10-21",43,32,"11/3/1992",13,11,43,37.4,5.6
1992,"1992-10-21",47,28,"11/3/1992",13,19,43,37.4,5.6
1992,"1992-10-21",45,31,"11/3/1992",13,14,43,37.4,5.6
1992,"1992-10-22",45,32,"11/3/1992",12,13,43,37.4,5.6
1992,"1992-10-22",42,34,"11/3/1992",12,8,43,37.4,5.6
1992,"1992-10-22",43,31,"11/3/1992",12,12,43,37.4,5.6
1992,"1992-10-22",41,33,"11/3/1992",12,8,43,37.4,5.6
1992,"1992-10-22",46,32,"11/3/1992",12,14,43,37.4,5.6
1992,"1992-10-22",40,37,"11/3/1992",12,3,43,37.4,5.6
1992,"1992-10-22",45,32,"11/3/1992",12,13,43,37.4,5.6
1992,"1992-10-23",42,37,"11/3/1992",11,5,43,37.4,5.6
1992,"1992-10-23",41,30,"11/3/1992",11,11,43,37.4,5.6
1992,"1992-10-23",42,30,"11/3/1992",11,12,43,37.4,5.6
1992,"1992-10-24",39,32,"11/3/1992",10,7,43,37.4,5.6
1992,"1992-10-24",44,34,"11/3/1992",10,10,43,37.4,5.6
1992,"1992-10-25",45,32,"11/3/1992",9,13,43,37.4,5.6
1992,"1992-10-25",42,31,"11/3/1992",9,11,43,37.4,5.6
1992,"1992-10-25",44,33,"11/3/1992",9,11,43,37.4,5.6
1992,"1992-10-26",44,32,"11/3/1992",8,12,43,37.4,5.6
1992,"1992-10-26",43,32,"11/3/1992",8,11,43,37.4,5.6
1992,"1992-10-26",42,36,"11/3/1992",8,6,43,37.4,5.6
1992,"1992-10-26",44,34,"11/3/1992",8,10,43,37.4,5.6
1992,"1992-10-26",42,31,"11/3/1992",8,11,43,37.4,5.6
1992,"1992-10-26",41,34,"11/3/1992",8,7,43,37.4,5.6
1992,"1992-10-27",42,34,"11/3/1992",7,8,43,37.4,5.6
1992,"1992-10-27",44,34,"11/3/1992",7,10,43,37.4,5.6
1992,"1992-10-27",42,31,"11/3/1992",7,11,43,37.4,5.6
1992,"1992-10-27",40,38,"11/3/1992",7,2,43,37.4,5.6
1992,"1992-10-27",42,35,"11/3/1992",7,7,43,37.4,5.6
1992,"1992-10-27",44,33,"11/3/1992",7,11,43,37.4,5.6
1992,"1992-10-27",43,36,"11/3/1992",7,7,43,37.4,5.6
1992,"1992-10-28",40,35,"11/3/1992",6,5,43,37.4,5.6
1992,"1992-10-28",40,34,"11/3/1992",6,6,43,37.4,5.6
1992,"1992-10-28",44,35,"11/3/1992",6,9,43,37.4,5.6
1992,"1992-10-28",41,38,"11/3/1992",6,3,43,37.4,5.6
1992,"1992-10-28",43,38,"11/3/1992",6,5,43,37.4,5.6
1992,"1992-10-28",45,35,"11/3/1992",6,10,43,37.4,5.6
1992,"1992-10-29",41,36,"11/3/1992",5,5,43,37.4,5.6
1992,"1992-10-29",45,35,"11/3/1992",5,10,43,37.4,5.6
1992,"1992-10-29",36,33,"11/3/1992",5,3,43,37.4,5.6
1992,"1992-10-29",43,35,"11/3/1992",5,8,43,37.4,5.6
1992,"1992-10-29",42,36,"11/3/1992",5,6,43,37.4,5.6
1992,"1992-10-29",41,39,"11/3/1992",5,2,43,37.4,5.6
1992,"1992-10-29",41,37,"11/3/1992",5,4,43,37.4,5.6
1992,"1992-10-29",41,40,"11/3/1992",5,1,43,37.4,5.6
1992,"1992-10-30",40,36,"11/3/1992",4,4,43,37.4,5.6
1992,"1992-10-30",42,36,"11/3/1992",4,6,43,37.4,5.6
1992,"1992-10-30",42,39,"11/3/1992",4,3,43,37.4,5.6
1992,"1992-10-30",41,38,"11/3/1992",4,3,43,37.4,5.6
1992,"1992-10-30",44,36,"11/3/1992",4,8,43,37.4,5.6
1992,"1992-10-31",41,35,"11/3/1992",3,6,43,37.4,5.6
1992,"1992-10-31",43,34,"11/3/1992",3,9,43,37.4,5.6
1992,"1992-10-31",43,36,"11/3/1992",3,7,43,37.4,5.6
1992,"1992-10-31",42,37,"11/3/1992",3,5,43,37.4,5.6
1992,"1992-11-01",43,35,"11/3/1992",2,8,43,37.4,5.6
1992,"1992-11-01",44,37,"11/3/1992",2,7,43,37.4,5.6
1992,"1992-11-01",40,36,"11/3/1992",2,4,43,37.4,5.6
1992,"1992-11-01",43,37,"11/3/1992",2,6,43,37.4,5.6
1992,"1992-11-01",44,36,"11/3/1992",2,8,43,37.4,5.6
1992,"1992-11-01",44,36,"11/3/1992",2,8,43,37.4,5.6
1992,"1992-11-01",44,36,"11/3/1992",2,8,43,37.4,5.6
1992,"1992-11-02",45,37,"11/3/1992",1,8,43,37.4,5.6
1992,"1992-11-02",44,37,"11/3/1992",1,7,43,37.4,5.6
1996,"1995-10-31",46,39,"11/5/1996",371,7,49.2,40.7,8.5
1996,"1995-10-31",30,26,"11/5/1996",371,4,49.2,40.7,8.5
1996,"1995-10-31",39,33,"11/5/1996",371,6,49.2,40.7,8.5
1996,"1995-11-06",48,42,"11/5/1996",365,6,49.2,40.7,8.5
1996,"1995-11-08",53,43,"11/5/1996",363,10,49.2,40.7,8.5
1996,"1995-11-08",51,41,"11/5/1996",363,10,49.2,40.7,8.5
1996,"1995-11-08",45,31,"11/5/1996",363,14,49.2,40.7,8.5
1996,"1995-11-08",48,35,"11/5/1996",363,13,49.2,40.7,8.5
1996,"1995-11-10",39,40,"11/5/1996",361,-1,49.2,40.7,8.5
1996,"1995-11-10",45,49,"11/5/1996",361,-4,49.2,40.7,8.5
1996,"1995-11-13",53,41,"11/5/1996",358,12,49.2,40.7,8.5
1996,"1995-11-14",50,42,"11/5/1996",357,8,49.2,40.7,8.5
1996,"1995-11-18",55,39,"11/5/1996",353,16,49.2,40.7,8.5
1996,"1995-11-18",47,37,"11/5/1996",353,10,49.2,40.7,8.5
1996,"1995-12-03",43,32,"11/5/1996",338,11,49.2,40.7,8.5
1996,"1995-12-05",50,40,"11/5/1996",336,10,49.2,40.7,8.5
1996,"1995-12-05",44,31,"11/5/1996",336,13,49.2,40.7,8.5
1996,"1995-12-07",53,34,"11/5/1996",334,19,49.2,40.7,8.5
1996,"1995-12-07",52,37,"11/5/1996",334,15,49.2,40.7,8.5
1996,"1995-12-16",44,30,"11/5/1996",325,14,49.2,40.7,8.5
1996,"1995-12-18",52,43,"11/5/1996",323,9,49.2,40.7,8.5
1996,"1995-12-18",54,43,"11/5/1996",323,11,49.2,40.7,8.5
1996,"1996-01-06",47,39,"11/5/1996",304,8,49.2,40.7,8.5
1996,"1996-01-07",46,49,"11/5/1996",303,-3,49.2,40.7,8.5
1996,"1996-01-10",49,42,"11/5/1996",300,7,49.2,40.7,8.5
1996,"1996-01-11",47,41,"11/5/1996",299,6,49.2,40.7,8.5
1996,"1996-01-14",53,41,"11/5/1996",296,12,49.2,40.7,8.5
1996,"1996-01-15",43,39,"11/5/1996",295,4,49.2,40.7,8.5
1996,"1996-01-15",48,49,"11/5/1996",295,-1,49.2,40.7,8.5
1996,"1996-01-16",47,40,"11/5/1996",294,7,49.2,40.7,8.5
1996,"1996-01-16",41,34,"11/5/1996",294,7,49.2,40.7,8.5
1996,"1996-01-17",49,37,"11/5/1996",293,12,49.2,40.7,8.5
1996,"1996-01-18",45,42,"11/5/1996",292,3,49.2,40.7,8.5
1996,"1996-01-20",51,40,"11/5/1996",290,11,49.2,40.7,8.5
1996,"1996-01-21",52,38,"11/5/1996",289,14,49.2,40.7,8.5
1996,"1996-01-22",47,32,"11/5/1996",288,15,49.2,40.7,8.5
1996,"1996-01-22",39,25,"11/5/1996",288,14,49.2,40.7,8.5
1996,"1996-01-26",44,37,"11/5/1996",284,7,49.2,40.7,8.5
1996,"1996-01-29",54,42,"11/5/1996",281,12,49.2,40.7,8.5
1996,"1996-01-29",44,33,"11/5/1996",281,11,49.2,40.7,8.5
1996,"1996-01-29",51,41,"11/5/1996",281,10,49.2,40.7,8.5
1996,"1996-02-16",48,35,"11/5/1996",263,13,49.2,40.7,8.5
1996,"1996-02-22",52,39,"11/5/1996",257,13,49.2,40.7,8.5
1996,"1996-02-24",54,36,"11/5/1996",255,18,49.2,40.7,8.5
1996,"1996-02-25",52,44,"11/5/1996",254,8,49.2,40.7,8.5
1996,"1996-02-25",56,40,"11/5/1996",254,16,49.2,40.7,8.5
1996,"1996-02-29",45,34,"11/5/1996",250,11,49.2,40.7,8.5
1996,"1996-03-05",53,34,"11/5/1996",245,19,49.2,40.7,8.5
1996,"1996-03-05",46,29,"11/5/1996",245,17,49.2,40.7,8.5
1996,"1996-03-10",56,39,"11/5/1996",240,17,49.2,40.7,8.5
1996,"1996-03-10",53,31,"11/5/1996",240,22,49.2,40.7,8.5
1996,"1996-03-10",50,32,"11/5/1996",240,18,49.2,40.7,8.5
1996,"1996-03-10",54,42,"11/5/1996",240,12,49.2,40.7,8.5
1996,"1996-03-11",56,39,"11/5/1996",239,17,49.2,40.7,8.5
1996,"1996-03-16",46,38,"11/5/1996",234,8,49.2,40.7,8.5
1996,"1996-03-16",51,34,"11/5/1996",234,17,49.2,40.7,8.5
1996,"1996-03-17",52,43,"11/5/1996",233,9,49.2,40.7,8.5
1996,"1996-03-17",46,36,"11/5/1996",233,10,49.2,40.7,8.5
1996,"1996-03-17",54,42,"11/5/1996",233,12,49.2,40.7,8.5
1996,"1996-04-01",53,41,"11/5/1996",218,12,49.2,40.7,8.5
1996,"1996-04-01",44,35,"11/5/1996",218,9,49.2,40.7,8.5
1996,"1996-04-01",45,30,"11/5/1996",218,15,49.2,40.7,8.5
1996,"1996-04-01",56,40,"11/5/1996",218,16,49.2,40.7,8.5
1996,"1996-04-01",49,32,"11/5/1996",218,17,49.2,40.7,8.5
1996,"1996-04-01",49,35,"11/5/1996",218,14,49.2,40.7,8.5
1996,"1996-04-01",58,39,"11/5/1996",218,19,49.2,40.7,8.5
1996,"1996-04-02",49,39,"11/5/1996",217,10,49.2,40.7,8.5
1996,"1996-04-02",55,41,"11/5/1996",217,14,49.2,40.7,8.5
1996,"1996-04-02",47,36,"11/5/1996",217,11,49.2,40.7,8.5
1996,"1996-04-02",51,34,"11/5/1996",217,17,49.2,40.7,8.5
1996,"1996-04-02",53,42,"11/5/1996",217,11,49.2,40.7,8.5
1996,"1996-04-02",44,33,"11/5/1996",217,11,49.2,40.7,8.5
1996,"1996-04-10",49,35,"11/5/1996",209,14,49.2,40.7,8.5
1996,"1996-04-10",57,40,"11/5/1996",209,17,49.2,40.7,8.5
1996,"1996-04-16",49,39,"11/5/1996",203,10,49.2,40.7,8.5
1996,"1996-04-22",57,37,"11/5/1996",197,20,49.2,40.7,8.5
1996,"1996-04-22",51,31,"11/5/1996",197,20,49.2,40.7,8.5
1996,"1996-04-25",54,40,"11/5/1996",194,14,49.2,40.7,8.5
1996,"1996-04-26",42,30,"11/5/1996",193,12,49.2,40.7,8.5
1996,"1996-04-28",49,35,"11/5/1996",191,14,49.2,40.7,8.5
1996,"1996-04-28",58,37,"11/5/1996",191,21,49.2,40.7,8.5
1996,"1996-05-09",50,38,"11/5/1996",180,12,49.2,40.7,8.5
1996,"1996-05-09",45,35,"11/5/1996",180,10,49.2,40.7,8.5
1996,"1996-05-12",47,32,"11/5/1996",177,15,49.2,40.7,8.5
1996,"1996-05-12",58,38,"11/5/1996",177,20,49.2,40.7,8.5
1996,"1996-05-14",54,37,"11/5/1996",175,17,49.2,40.7,8.5
1996,"1996-05-14",48,31,"11/5/1996",175,17,49.2,40.7,8.5
1996,"1996-05-15",56,41,"11/5/1996",174,15,49.2,40.7,8.5
1996,"1996-05-16",53,28,"11/5/1996",173,25,49.2,40.7,8.5
1996,"1996-05-16",48,37,"11/5/1996",173,11,49.2,40.7,8.5
1996,"1996-05-16",47,25,"11/5/1996",173,22,49.2,40.7,8.5
1996,"1996-05-16",50,39,"11/5/1996",173,11,49.2,40.7,8.5
1996,"1996-05-16",56,34,"11/5/1996",173,22,49.2,40.7,8.5
1996,"1996-05-17",49,33,"11/5/1996",172,16,49.2,40.7,8.5
1996,"1996-05-22",57,35,"11/5/1996",167,22,49.2,40.7,8.5
1996,"1996-05-22",58,35,"11/5/1996",167,23,49.2,40.7,8.5
1996,"1996-05-22",51,29,"11/5/1996",167,22,49.2,40.7,8.5
1996,"1996-05-22",53,31,"11/5/1996",167,22,49.2,40.7,8.5
1996,"1996-05-23",52,35,"11/5/1996",166,17,49.2,40.7,8.5
1996,"1996-05-29",49,34,"11/5/1996",160,15,49.2,40.7,8.5
1996,"1996-05-29",56,40,"11/5/1996",160,16,49.2,40.7,8.5
1996,"1996-05-31",44,31,"11/5/1996",158,13,49.2,40.7,8.5
1996,"1996-05-31",49,32,"11/5/1996",158,17,49.2,40.7,8.5
1996,"1996-06-03",57,35,"11/5/1996",155,22,49.2,40.7,8.5
1996,"1996-06-03",48,32,"11/5/1996",155,16,49.2,40.7,8.5
1996,"1996-06-03",52,39,"11/5/1996",155,13,49.2,40.7,8.5
1996,"1996-06-03",48,35,"11/5/1996",155,13,49.2,40.7,8.5
1996,"1996-06-09",55,40,"11/5/1996",149,15,49.2,40.7,8.5
1996,"1996-06-10",49,31,"11/5/1996",148,18,49.2,40.7,8.5
1996,"1996-06-10",45,27,"11/5/1996",148,18,49.2,40.7,8.5
1996,"1996-06-10",51,34,"11/5/1996",148,17,49.2,40.7,8.5
1996,"1996-06-11",47,38,"11/5/1996",147,9,49.2,40.7,8.5
1996,"1996-06-13",49,43,"11/5/1996",145,6,49.2,40.7,8.5
1996,"1996-06-18",55,35,"11/5/1996",140,20,49.2,40.7,8.5
1996,"1996-06-19",45,39,"11/5/1996",139,6,49.2,40.7,8.5
1996,"1996-06-19",39,36,"11/5/1996",139,3,49.2,40.7,8.5
1996,"1996-06-19",57,38,"11/5/1996",139,19,49.2,40.7,8.5
1996,"1996-06-23",50,38,"11/5/1996",135,12,49.2,40.7,8.5
1996,"1996-06-23",46,34,"11/5/1996",135,12,49.2,40.7,8.5
1996,"1996-06-23",54,34,"11/5/1996",135,20,49.2,40.7,8.5
1996,"1996-06-23",51,31,"11/5/1996",135,20,49.2,40.7,8.5
1996,"1996-06-25",52,36,"11/5/1996",133,16,49.2,40.7,8.5
1996,"1996-06-25",41,30,"11/5/1996",133,11,49.2,40.7,8.5
1996,"1996-06-25",54,37,"11/5/1996",133,17,49.2,40.7,8.5
1996,"1996-06-25",47,32,"11/5/1996",133,15,49.2,40.7,8.5
1996,"1996-06-28",49,33,"11/5/1996",130,16,49.2,40.7,8.5
1996,"1996-06-28",44,31,"11/5/1996",130,13,49.2,40.7,8.5
1996,"1996-06-30",54,40,"11/5/1996",128,14,49.2,40.7,8.5
1996,"1996-06-30",53,43,"11/5/1996",128,10,49.2,40.7,8.5
1996,"1996-06-30",48,33,"11/5/1996",128,15,49.2,40.7,8.5
1996,"1996-06-30",49,37,"11/5/1996",128,12,49.2,40.7,8.5
1996,"1996-06-30",54,39,"11/5/1996",128,15,49.2,40.7,8.5
1996,"1996-07-11",49,39,"11/5/1996",117,10,49.2,40.7,8.5
1996,"1996-07-11",53,38,"11/5/1996",117,15,49.2,40.7,8.5
1996,"1996-07-11",52,36,"11/5/1996",117,16,49.2,40.7,8.5
1996,"1996-07-11",48,32,"11/5/1996",117,16,49.2,40.7,8.5
1996,"1996-07-11",49,38,"11/5/1996",117,11,49.2,40.7,8.5
1996,"1996-07-11",43,33,"11/5/1996",117,10,49.2,40.7,8.5
1996,"1996-07-12",44,31,"11/5/1996",116,13,49.2,40.7,8.5
1996,"1996-07-12",46,35,"11/5/1996",116,11,49.2,40.7,8.5
1996,"1996-07-13",60,35,"11/5/1996",115,25,49.2,40.7,8.5
1996,"1996-07-13",59,34,"11/5/1996",115,25,49.2,40.7,8.5
1996,"1996-07-13",54,29,"11/5/1996",115,25,49.2,40.7,8.5
1996,"1996-07-13",49,34,"11/5/1996",115,15,49.2,40.7,8.5
1996,"1996-07-13",49,27,"11/5/1996",115,22,49.2,40.7,8.5
1996,"1996-07-13",57,37,"11/5/1996",115,20,49.2,40.7,8.5
1996,"1996-07-14",54,30,"11/5/1996",114,24,49.2,40.7,8.5
1996,"1996-07-14",53,29,"11/5/1996",114,24,49.2,40.7,8.5
1996,"1996-07-14",50,25,"11/5/1996",114,25,49.2,40.7,8.5
1996,"1996-07-16",45,33,"11/5/1996",112,12,49.2,40.7,8.5
1996,"1996-07-17",52,36,"11/5/1996",111,16,49.2,40.7,8.5
1996,"1996-07-21",46,32,"11/5/1996",107,14,49.2,40.7,8.5
1996,"1996-07-21",46,32,"11/5/1996",107,14,49.2,40.7,8.5
1996,"1996-07-21",54,34,"11/5/1996",107,20,49.2,40.7,8.5
1996,"1996-07-21",50,33,"11/5/1996",107,17,49.2,40.7,8.5
1996,"1996-07-21",56,39,"11/5/1996",107,17,49.2,40.7,8.5
1996,"1996-07-26",42,27,"11/5/1996",102,15,49.2,40.7,8.5
1996,"1996-07-28",44,34,"11/5/1996",100,10,49.2,40.7,8.5
1996,"1996-07-28",50,35,"11/5/1996",100,15,49.2,40.7,8.5
1996,"1996-07-28",53,42,"11/5/1996",100,11,49.2,40.7,8.5
1996,"1996-07-28",57,39,"11/5/1996",100,18,49.2,40.7,8.5
1996,"1996-07-30",53,33,"11/5/1996",98,20,49.2,40.7,8.5
1996,"1996-07-30",55,35,"11/5/1996",98,20,49.2,40.7,8.5
1996,"1996-07-30",58,38,"11/5/1996",98,20,49.2,40.7,8.5
1996,"1996-08-05",43,31,"11/5/1996",92,12,49.2,40.7,8.5
1996,"1996-08-05",55,40,"11/5/1996",92,15,49.2,40.7,8.5
1996,"1996-08-05",50,34,"11/5/1996",92,16,49.2,40.7,8.5
1996,"1996-08-05",54,38,"11/5/1996",92,16,49.2,40.7,8.5
1996,"1996-08-05",59,36,"11/5/1996",92,23,49.2,40.7,8.5
1996,"1996-08-05",58,28,"11/5/1996",92,30,49.2,40.7,8.5
1996,"1996-08-06",34,18,"11/5/1996",91,16,49.2,40.7,8.5
1996,"1996-08-06",50,30,"11/5/1996",91,20,49.2,40.7,8.5
1996,"1996-08-06",55,35,"11/5/1996",91,20,49.2,40.7,8.5
1996,"1996-08-06",56,36,"11/5/1996",91,20,49.2,40.7,8.5
1996,"1996-08-06",47,30,"11/5/1996",91,17,49.2,40.7,8.5
1996,"1996-08-07",52,30,"11/5/1996",90,22,49.2,40.7,8.5
1996,"1996-08-07",58,35,"11/5/1996",90,23,49.2,40.7,8.5
1996,"1996-08-08",50,35,"11/5/1996",89,15,49.2,40.7,8.5
1996,"1996-08-08",43,32,"11/5/1996",89,11,49.2,40.7,8.5
1996,"1996-08-09",53,33,"11/5/1996",88,20,49.2,40.7,8.5
1996,"1996-08-09",58,37,"11/5/1996",88,21,49.2,40.7,8.5
1996,"1996-08-09",45,28,"11/5/1996",88,17,49.2,40.7,8.5
1996,"1996-08-09",44,33,"11/5/1996",88,11,49.2,40.7,8.5
1996,"1996-08-10",56,37,"11/5/1996",87,19,49.2,40.7,8.5
1996,"1996-08-10",51,32,"11/5/1996",87,19,49.2,40.7,8.5
1996,"1996-08-11",56,36,"11/5/1996",86,20,49.2,40.7,8.5
1996,"1996-08-11",51,32,"11/5/1996",86,19,49.2,40.7,8.5
1996,"1996-08-11",50,38,"11/5/1996",86,12,49.2,40.7,8.5
1996,"1996-08-11",53,44,"11/5/1996",86,9,49.2,40.7,8.5
1996,"1996-08-12",55,37,"11/5/1996",85,18,49.2,40.7,8.5
1996,"1996-08-12",49,33,"11/5/1996",85,16,49.2,40.7,8.5
1996,"1996-08-12",48,36,"11/5/1996",85,12,49.2,40.7,8.5
1996,"1996-08-13",46,36,"11/5/1996",84,10,49.2,40.7,8.5
1996,"1996-08-13",42,34,"11/5/1996",84,8,49.2,40.7,8.5
1996,"1996-08-13",47,37,"11/5/1996",84,10,49.2,40.7,8.5
1996,"1996-08-13",47,35,"11/5/1996",84,12,49.2,40.7,8.5
1996,"1996-08-14",55,39,"11/5/1996",83,16,49.2,40.7,8.5
1996,"1996-08-14",48,37,"11/5/1996",83,11,49.2,40.7,8.5
1996,"1996-08-14",50,33,"11/5/1996",83,17,49.2,40.7,8.5
1996,"1996-08-15",47,38,"11/5/1996",82,9,49.2,40.7,8.5
1996,"1996-08-15",50,39,"11/5/1996",82,11,49.2,40.7,8.5
1996,"1996-08-15",52,42,"11/5/1996",82,10,49.2,40.7,8.5
1996,"1996-08-16",44,42,"11/5/1996",81,2,49.2,40.7,8.5
1996,"1996-08-16",48,45,"11/5/1996",81,3,49.2,40.7,8.5
1996,"1996-08-18",44,40,"11/5/1996",79,4,49.2,40.7,8.5
1996,"1996-08-18",49,37,"11/5/1996",79,12,49.2,40.7,8.5
1996,"1996-08-18",54,42,"11/5/1996",79,12,49.2,40.7,8.5
1996,"1996-08-18",48,41,"11/5/1996",79,7,49.2,40.7,8.5
1996,"1996-08-18",51,46,"11/5/1996",79,5,49.2,40.7,8.5
1996,"1996-08-19",50,38,"11/5/1996",78,12,49.2,40.7,8.5
1996,"1996-08-19",49,39,"11/5/1996",78,10,49.2,40.7,8.5
1996,"1996-08-19",49,37,"11/5/1996",78,12,49.2,40.7,8.5
1996,"1996-08-20",46,36,"11/5/1996",77,10,49.2,40.7,8.5
1996,"1996-08-20",42,36,"11/5/1996",77,6,49.2,40.7,8.5
1996,"1996-08-20",43,39,"11/5/1996",77,4,49.2,40.7,8.5
1996,"1996-08-21",32,27,"11/5/1996",76,5,49.2,40.7,8.5
1996,"1996-08-21",52,40,"11/5/1996",76,12,49.2,40.7,8.5
1996,"1996-08-21",48,38,"11/5/1996",76,10,49.2,40.7,8.5
1996,"1996-08-22",45,36,"11/5/1996",75,9,49.2,40.7,8.5
1996,"1996-08-23",45,38,"11/5/1996",74,7,49.2,40.7,8.5
1996,"1996-08-23",51,41,"11/5/1996",74,10,49.2,40.7,8.5
1996,"1996-08-23",47,40,"11/5/1996",74,7,49.2,40.7,8.5
1996,"1996-08-23",53,43,"11/5/1996",74,10,49.2,40.7,8.5
1996,"1996-08-24",47,38,"11/5/1996",73,9,49.2,40.7,8.5
1996,"1996-08-24",47,42,"11/5/1996",73,5,49.2,40.7,8.5
1996,"1996-08-25",50,38,"11/5/1996",72,12,49.2,40.7,8.5
1996,"1996-08-25",54,41,"11/5/1996",72,13,49.2,40.7,8.5
1996,"1996-08-25",47,38,"11/5/1996",72,9,49.2,40.7,8.5
1996,"1996-08-25",47,42,"11/5/1996",72,5,49.2,40.7,8.5
1996,"1996-08-26",51,36,"11/5/1996",71,15,49.2,40.7,8.5
1996,"1996-08-26",50,39,"11/5/1996",71,11,49.2,40.7,8.5
1996,"1996-08-26",46,38,"11/5/1996",71,8,49.2,40.7,8.5
1996,"1996-08-27",47,34,"11/5/1996",70,13,49.2,40.7,8.5
1996,"1996-08-27",51,36,"11/5/1996",70,15,49.2,40.7,8.5
1996,"1996-08-27",51,36,"11/5/1996",70,15,49.2,40.7,8.5
1996,"1996-08-27",54,40,"11/5/1996",70,14,49.2,40.7,8.5
1996,"1996-08-27",52,38,"11/5/1996",70,14,49.2,40.7,8.5
1996,"1996-08-27",45,38,"11/5/1996",70,7,49.2,40.7,8.5
1996,"1996-08-28",52,35,"11/5/1996",69,17,49.2,40.7,8.5
1996,"1996-08-28",52,38,"11/5/1996",69,14,49.2,40.7,8.5
1996,"1996-08-28",49,39,"11/5/1996",69,10,49.2,40.7,8.5
1996,"1996-08-29",54,33,"11/5/1996",68,21,49.2,40.7,8.5
1996,"1996-08-29",56,36,"11/5/1996",68,20,49.2,40.7,8.5
1996,"1996-08-29",54,34,"11/5/1996",68,20,49.2,40.7,8.5
1996,"1996-08-29",51,38,"11/5/1996",68,13,49.2,40.7,8.5
1996,"1996-08-29",54,37,"11/5/1996",68,17,49.2,40.7,8.5
1996,"1996-08-29",57,40,"11/5/1996",68,17,49.2,40.7,8.5
1996,"1996-09-01",55,34,"11/5/1996",65,21,49.2,40.7,8.5
1996,"1996-09-04",48,33,"11/5/1996",62,15,49.2,40.7,8.5
1996,"1996-09-04",53,36,"11/5/1996",62,17,49.2,40.7,8.5
1996,"1996-09-04",57,38,"11/5/1996",62,19,49.2,40.7,8.5
1996,"1996-09-04",54,36,"11/5/1996",62,18,49.2,40.7,8.5
1996,"1996-09-04",52,35,"11/5/1996",62,17,49.2,40.7,8.5
1996,"1996-09-04",51,37,"11/5/1996",62,14,49.2,40.7,8.5
1996,"1996-09-04",51,40,"11/5/1996",62,11,49.2,40.7,8.5
1996,"1996-09-05",49,34,"11/5/1996",61,15,49.2,40.7,8.5
1996,"1996-09-05",52,36,"11/5/1996",61,16,49.2,40.7,8.5
1996,"1996-09-05",52,36,"11/5/1996",61,16,49.2,40.7,8.5
1996,"1996-09-06",53,36,"11/5/1996",60,17,49.2,40.7,8.5
1996,"1996-09-06",52,34,"11/5/1996",60,18,49.2,40.7,8.5
1996,"1996-09-07",54,36,"11/5/1996",59,18,49.2,40.7,8.5
1996,"1996-09-08",51,34,"11/5/1996",58,17,49.2,40.7,8.5
1996,"1996-09-08",54,35,"11/5/1996",58,19,49.2,40.7,8.5
1996,"1996-09-08",53,38,"11/5/1996",58,15,49.2,40.7,8.5
1996,"1996-09-08",52,34,"11/5/1996",58,18,49.2,40.7,8.5
1996,"1996-09-08",52,37,"11/5/1996",58,15,49.2,40.7,8.5
1996,"1996-09-08",55,34,"11/5/1996",58,21,49.2,40.7,8.5
1996,"1996-09-09",54,31,"11/5/1996",57,23,49.2,40.7,8.5
1996,"1996-09-09",55,34,"11/5/1996",57,21,49.2,40.7,8.5
1996,"1996-09-09",51,35,"11/5/1996",57,16,49.2,40.7,8.5
1996,"1996-09-09",50,34,"11/5/1996",57,16,49.2,40.7,8.5
1996,"1996-09-10",52,33,"11/5/1996",56,19,49.2,40.7,8.5
1996,"1996-09-10",55,34,"11/5/1996",56,21,49.2,40.7,8.5
1996,"1996-09-11",51,35,"11/5/1996",55,16,49.2,40.7,8.5
1996,"1996-09-11",55,34,"11/5/1996",55,21,49.2,40.7,8.5
1996,"1996-09-12",50,35,"11/5/1996",54,15,49.2,40.7,8.5
1996,"1996-09-12",55,32,"11/5/1996",54,23,49.2,40.7,8.5
1996,"1996-09-13",42,32,"11/5/1996",53,10,49.2,40.7,8.5
1996,"1996-09-14",51,34,"11/5/1996",52,17,49.2,40.7,8.5
1996,"1996-09-15",47,39,"11/5/1996",51,8,49.2,40.7,8.5
1996,"1996-09-15",49,41,"11/5/1996",51,8,49.2,40.7,8.5
1996,"1996-09-15",50,38,"11/5/1996",51,12,49.2,40.7,8.5
1996,"1996-09-15",51,35,"11/5/1996",51,16,49.2,40.7,8.5
1996,"1996-09-15",49,33,"11/5/1996",51,16,49.2,40.7,8.5
1996,"1996-09-16",47,39,"11/5/1996",50,8,49.2,40.7,8.5
1996,"1996-09-16",50,36,"11/5/1996",50,14,49.2,40.7,8.5
1996,"1996-09-17",47,39,"11/5/1996",49,8,49.2,40.7,8.5
1996,"1996-09-17",51,38,"11/5/1996",49,13,49.2,40.7,8.5
1996,"1996-09-17",52,35,"11/5/1996",49,17,49.2,40.7,8.5
1996,"1996-09-18",46,40,"11/5/1996",48,6,49.2,40.7,8.5
1996,"1996-09-18",52,36,"11/5/1996",48,16,49.2,40.7,8.5
1996,"1996-09-18",56,34,"11/5/1996",48,22,49.2,40.7,8.5
1996,"1996-09-18",59,37,"11/5/1996",48,22,49.2,40.7,8.5
1996,"1996-09-19",48,37,"11/5/1996",47,11,49.2,40.7,8.5
1996,"1996-09-19",55,34,"11/5/1996",47,21,49.2,40.7,8.5
1996,"1996-09-20",51,35,"11/5/1996",46,16,49.2,40.7,8.5
1996,"1996-09-20",55,38,"11/5/1996",46,17,49.2,40.7,8.5
1996,"1996-09-21",53,34,"11/5/1996",45,19,49.2,40.7,8.5
1996,"1996-09-22",48,37,"11/5/1996",44,11,49.2,40.7,8.5
1996,"1996-09-22",48,36,"11/5/1996",44,12,49.2,40.7,8.5
1996,"1996-09-22",51,37,"11/5/1996",44,14,49.2,40.7,8.5
1996,"1996-09-22",52,40,"11/5/1996",44,12,49.2,40.7,8.5
1996,"1996-09-22",53,36,"11/5/1996",44,17,49.2,40.7,8.5
1996,"1996-09-23",50,36,"11/5/1996",43,14,49.2,40.7,8.5
1996,"1996-09-23",51,38,"11/5/1996",43,13,49.2,40.7,8.5
1996,"1996-09-24",52,34,"11/5/1996",42,18,49.2,40.7,8.5
1996,"1996-09-24",51,38,"11/5/1996",42,13,49.2,40.7,8.5
1996,"1996-09-25",51,34,"11/5/1996",41,17,49.2,40.7,8.5
1996,"1996-09-25",49,39,"11/5/1996",41,10,49.2,40.7,8.5
1996,"1996-09-26",52,37,"11/5/1996",40,15,49.2,40.7,8.5
1996,"1996-09-26",52,34,"11/5/1996",40,18,49.2,40.7,8.5
1996,"1996-09-27",48,39,"11/5/1996",39,9,49.2,40.7,8.5
1996,"1996-09-28",51,37,"11/5/1996",38,14,49.2,40.7,8.5
1996,"1996-09-29",50,36,"11/5/1996",37,14,49.2,40.7,8.5
1996,"1996-09-29",51,35,"11/5/1996",37,16,49.2,40.7,8.5
1996,"1996-09-29",52,37,"11/5/1996",37,15,49.2,40.7,8.5
1996,"1996-09-29",53,34,"11/5/1996",37,19,49.2,40.7,8.5
1996,"1996-09-29",56,34,"11/5/1996",37,22,49.2,40.7,8.5
1996,"1996-09-30",49,35,"11/5/1996",36,14,49.2,40.7,8.5
1996,"1996-09-30",55,34,"11/5/1996",36,21,49.2,40.7,8.5
1996,"1996-09-30",45,34,"11/5/1996",36,11,49.2,40.7,8.5
1996,"1996-09-30",57,32,"11/5/1996",36,25,49.2,40.7,8.5
1996,"1996-10-01",48,35,"11/5/1996",35,13,49.2,40.7,8.5
1996,"1996-10-01",45,34,"11/5/1996",35,11,49.2,40.7,8.5
1996,"1996-10-01",55,34,"11/5/1996",35,21,49.2,40.7,8.5
1996,"1996-10-02",48,36,"11/5/1996",34,12,49.2,40.7,8.5
1996,"1996-10-02",46,33,"11/5/1996",34,13,49.2,40.7,8.5
1996,"1996-10-02",53,36,"11/5/1996",34,17,49.2,40.7,8.5
1996,"1996-10-03",50,33,"11/5/1996",33,17,49.2,40.7,8.5
1996,"1996-10-03",48,33,"11/5/1996",33,15,49.2,40.7,8.5
1996,"1996-10-03",53,32,"11/5/1996",33,21,49.2,40.7,8.5
1996,"1996-10-03",53,37,"11/5/1996",33,16,49.2,40.7,8.5
1996,"1996-10-04",50,30,"11/5/1996",32,20,49.2,40.7,8.5
1996,"1996-10-04",53,36,"11/5/1996",32,17,49.2,40.7,8.5
1996,"1996-10-05",47,32,"11/5/1996",31,15,49.2,40.7,8.5
1996,"1996-10-05",54,36,"11/5/1996",31,18,49.2,40.7,8.5
1996,"1996-10-06",50,34,"11/5/1996",30,16,49.2,40.7,8.5
1996,"1996-10-06",44,35,"11/5/1996",30,9,49.2,40.7,8.5
1996,"1996-10-06",49,35,"11/5/1996",30,14,49.2,40.7,8.5
1996,"1996-10-06",55,35,"11/5/1996",30,20,49.2,40.7,8.5
1996,"1996-10-07",50,34,"11/5/1996",29,16,49.2,40.7,8.5
1996,"1996-10-07",44,39,"11/5/1996",29,5,49.2,40.7,8.5
1996,"1996-10-07",56,34,"11/5/1996",29,22,49.2,40.7,8.5
1996,"1996-10-08",50,35,"11/5/1996",28,15,49.2,40.7,8.5
1996,"1996-10-08",45,37,"11/5/1996",28,8,49.2,40.7,8.5
1996,"1996-10-08",56,35,"11/5/1996",28,21,49.2,40.7,8.5
1996,"1996-10-08",54,38,"11/5/1996",28,16,49.2,40.7,8.5
1996,"1996-10-08",55,34,"11/5/1996",28,21,49.2,40.7,8.5
1996,"1996-10-09",47,35,"11/5/1996",27,12,49.2,40.7,8.5
1996,"1996-10-09",50,35,"11/5/1996",27,15,49.2,40.7,8.5
1996,"1996-10-09",44,36,"11/5/1996",27,8,49.2,40.7,8.5
1996,"1996-10-09",50,38,"11/5/1996",27,12,49.2,40.7,8.5
1996,"1996-10-10",47,35,"11/5/1996",26,12,49.2,40.7,8.5
1996,"1996-10-10",50,36,"11/5/1996",26,14,49.2,40.7,8.5
1996,"1996-10-10",44,34,"11/5/1996",26,10,49.2,40.7,8.5
1996,"1996-10-10",51,38,"11/5/1996",26,13,49.2,40.7,8.5
1996,"1996-10-11",45,34,"11/5/1996",25,11,49.2,40.7,8.5
1996,"1996-10-11",53,35,"11/5/1996",25,18,49.2,40.7,8.5
1996,"1996-10-11",57,34,"11/5/1996",25,23,49.2,40.7,8.5
1996,"1996-10-12",46,33,"11/5/1996",24,13,49.2,40.7,8.5
1996,"1996-10-12",56,35,"11/5/1996",24,21,49.2,40.7,8.5
1996,"1996-10-13",49,37,"11/5/1996",23,12,49.2,40.7,8.5
1996,"1996-10-13",53,36,"11/5/1996",23,17,49.2,40.7,8.5
1996,"1996-10-13",55,37,"11/5/1996",23,18,49.2,40.7,8.5
1996,"1996-10-13",48,33,"11/5/1996",23,15,49.2,40.7,8.5
1996,"1996-10-13",54,39,"11/5/1996",23,15,49.2,40.7,8.5
1996,"1996-10-13",54,36,"11/5/1996",23,18,49.2,40.7,8.5
1996,"1996-10-14",51,36,"11/5/1996",22,15,49.2,40.7,8.5
1996,"1996-10-14",47,32,"11/5/1996",22,15,49.2,40.7,8.5
1996,"1996-10-14",53,38,"11/5/1996",22,15,49.2,40.7,8.5
1996,"1996-10-14",51,38,"11/5/1996",22,13,49.2,40.7,8.5
1996,"1996-10-15",50,37,"11/5/1996",21,13,49.2,40.7,8.5
1996,"1996-10-15",46,33,"11/5/1996",21,13,49.2,40.7,8.5
1996,"1996-10-15",55,38,"11/5/1996",21,17,49.2,40.7,8.5
1996,"1996-10-15",48,39,"11/5/1996",21,9,49.2,40.7,8.5
1996,"1996-10-16",50,36,"11/5/1996",20,14,49.2,40.7,8.5
1996,"1996-10-16",46,33,"11/5/1996",20,13,49.2,40.7,8.5
1996,"1996-10-16",54,41,"11/5/1996",20,13,49.2,40.7,8.5
1996,"1996-10-16",50,38,"11/5/1996",20,12,49.2,40.7,8.5
1996,"1996-10-17",51,36,"11/5/1996",19,15,49.2,40.7,8.5
1996,"1996-10-17",44,35,"11/5/1996",19,9,49.2,40.7,8.5
1996,"1996-10-17",51,36,"11/5/1996",19,15,49.2,40.7,8.5
1996,"1996-10-18",45,37,"11/5/1996",18,8,49.2,40.7,8.5
1996,"1996-10-18",52,41,"11/5/1996",18,11,49.2,40.7,8.5
1996,"1996-10-18",52,29,"11/5/1996",18,23,49.2,40.7,8.5
1996,"1996-10-18",55,32,"11/5/1996",18,23,49.2,40.7,8.5
1996,"1996-10-19",45,37,"11/5/1996",17,8,49.2,40.7,8.5
1996,"1996-10-19",52,40,"11/5/1996",17,12,49.2,40.7,8.5
1996,"1996-10-19",54,35,"11/5/1996",17,19,49.2,40.7,8.5
1996,"1996-10-20",51,34,"11/5/1996",16,17,49.2,40.7,8.5
1996,"1996-10-20",49,35,"11/5/1996",16,14,49.2,40.7,8.5
1996,"1996-10-20",58,34,"11/5/1996",16,24,49.2,40.7,8.5
1996,"1996-10-20",54,36,"11/5/1996",16,18,49.2,40.7,8.5
1996,"1996-10-20",47,36,"11/5/1996",16,11,49.2,40.7,8.5
1996,"1996-10-20",53,38,"11/5/1996",16,15,49.2,40.7,8.5
1996,"1996-10-20",55,34,"11/5/1996",16,21,49.2,40.7,8.5
1996,"1996-10-21",48,36,"11/5/1996",15,12,49.2,40.7,8.5
1996,"1996-10-21",46,35,"11/5/1996",15,11,49.2,40.7,8.5
1996,"1996-10-21",53,40,"11/5/1996",15,13,49.2,40.7,8.5
1996,"1996-10-21",52,33,"11/5/1996",15,19,49.2,40.7,8.5
1996,"1996-10-22",48,38,"11/5/1996",14,10,49.2,40.7,8.5
1996,"1996-10-22",52,35,"11/5/1996",14,17,49.2,40.7,8.5
1996,"1996-10-22",46,35,"11/5/1996",14,11,49.2,40.7,8.5
1996,"1996-10-22",52,40,"11/5/1996",14,12,49.2,40.7,8.5
1996,"1996-10-22",51,35,"11/5/1996",14,16,49.2,40.7,8.5
1996,"1996-10-23",48,38,"11/5/1996",13,10,49.2,40.7,8.5
1996,"1996-10-23",45,36,"11/5/1996",13,9,49.2,40.7,8.5
1996,"1996-10-23",53,35,"11/5/1996",13,18,49.2,40.7,8.5
1996,"1996-10-23",53,38,"11/5/1996",13,15,49.2,40.7,8.5
1996,"1996-10-23",55,38,"11/5/1996",13,17,49.2,40.7,8.5
1996,"1996-10-23",51,34,"11/5/1996",13,17,49.2,40.7,8.5
1996,"1996-10-24",47,38,"11/5/1996",12,9,49.2,40.7,8.5
1996,"1996-10-24",46,35,"11/5/1996",12,11,49.2,40.7,8.5
1996,"1996-10-24",51,39,"11/5/1996",12,12,49.2,40.7,8.5
1996,"1996-10-24",51,34,"11/5/1996",12,17,49.2,40.7,8.5
1996,"1996-10-25",47,34,"11/5/1996",11,13,49.2,40.7,8.5
1996,"1996-10-25",54,34,"11/5/1996",11,20,49.2,40.7,8.5
1996,"1996-10-25",51,38,"11/5/1996",11,13,49.2,40.7,8.5
1996,"1996-10-25",48,35,"11/5/1996",11,13,49.2,40.7,8.5
1996,"1996-10-26",47,33,"11/5/1996",10,14,49.2,40.7,8.5
1996,"1996-10-26",53,38,"11/5/1996",10,15,49.2,40.7,8.5
1996,"1996-10-26",52,35,"11/5/1996",10,17,49.2,40.7,8.5
1996,"1996-10-27",48,36,"11/5/1996",9,12,49.2,40.7,8.5
1996,"1996-10-27",58,33,"11/5/1996",9,25,49.2,40.7,8.5
1996,"1996-10-27",51,34,"11/5/1996",9,17,49.2,40.7,8.5
1996,"1996-10-27",47,34,"11/5/1996",9,13,49.2,40.7,8.5
1996,"1996-10-27",55,36,"11/5/1996",9,19,49.2,40.7,8.5
1996,"1996-10-27",49,37,"11/5/1996",9,12,49.2,40.7,8.5
1996,"1996-10-28",47,35,"11/5/1996",8,12,49.2,40.7,8.5
1996,"1996-10-28",46,33,"11/5/1996",8,13,49.2,40.7,8.5
1996,"1996-10-28",54,35,"11/5/1996",8,19,49.2,40.7,8.5
1996,"1996-10-28",51,35,"11/5/1996",8,16,49.2,40.7,8.5
1996,"1996-10-29",43,33,"11/5/1996",7,10,49.2,40.7,8.5
1996,"1996-10-29",46,35,"11/5/1996",7,11,49.2,40.7,8.5
1996,"1996-10-29",43,33,"11/5/1996",7,10,49.2,40.7,8.5
1996,"1996-10-29",54,36,"11/5/1996",7,18,49.2,40.7,8.5
1996,"1996-10-29",53,36,"11/5/1996",7,17,49.2,40.7,8.5
1996,"1996-10-29",49,35,"11/5/1996",7,14,49.2,40.7,8.5
1996,"1996-10-30",51,35,"11/5/1996",6,16,49.2,40.7,8.5
1996,"1996-10-30",47,35,"11/5/1996",6,12,49.2,40.7,8.5
1996,"1996-10-30",42,34,"11/5/1996",6,8,49.2,40.7,8.5
1996,"1996-10-30",51,39,"11/5/1996",6,12,49.2,40.7,8.5
1996,"1996-10-30",51,35,"11/5/1996",6,16,49.2,40.7,8.5
1996,"1996-10-31",45,36,"11/5/1996",5,9,49.2,40.7,8.5
1996,"1996-10-31",42,37,"11/5/1996",5,5,49.2,40.7,8.5
1996,"1996-10-31",51,40,"11/5/1996",5,11,49.2,40.7,8.5
1996,"1996-10-31",52,34,"11/5/1996",5,18,49.2,40.7,8.5
1996,"1996-11-01",42,39,"11/5/1996",4,3,49.2,40.7,8.5
1996,"1996-11-01",50,40,"11/5/1996",4,10,49.2,40.7,8.5
1996,"1996-11-01",50,37,"11/5/1996",4,13,49.2,40.7,8.5
1996,"1996-11-02",53,35,"11/5/1996",3,18,49.2,40.7,8.5
1996,"1996-11-02",51,40,"11/5/1996",3,11,49.2,40.7,8.5
1996,"1996-11-02",44,40,"11/5/1996",3,4,49.2,40.7,8.5
1996,"1996-11-02",50,37,"11/5/1996",3,13,49.2,40.7,8.5
1996,"1996-11-03",49,36,"11/5/1996",2,13,49.2,40.7,8.5
1996,"1996-11-03",44,37,"11/5/1996",2,7,49.2,40.7,8.5
1996,"1996-11-03",51,39,"11/5/1996",2,12,49.2,40.7,8.5
1996,"1996-11-03",51,39,"11/5/1996",2,12,49.2,40.7,8.5
1996,"1996-11-03",51,35,"11/5/1996",2,16,49.2,40.7,8.5
1996,"1996-11-03",49,37,"11/5/1996",2,12,49.2,40.7,8.5
1996,"1996-11-04",49,36,"11/5/1996",1,13,49.2,40.7,8.5
2000,"1999-10-31",39,48,"11/7/2000",373,-9,48.4,47.9,0.5
2000,"1999-10-31",39,48,"11/7/2000",373,-9,48.4,47.9,0.5
2000,"1999-10-31",39,51,"11/7/2000",373,-12,48.4,47.9,0.5
2000,"1999-10-31",39,51,"11/7/2000",373,-12,48.4,47.9,0.5
2000,"1999-10-31",37,50,"11/7/2000",373,-13,48.4,47.9,0.5
2000,"1999-10-31",39,55,"11/7/2000",373,-16,48.4,47.9,0.5
2000,"1999-11-04",33,56,"11/7/2000",369,-23,48.4,47.9,0.5
2000,"1999-11-07",41,50,"11/7/2000",366,-9,48.4,47.9,0.5
2000,"1999-11-07",40,46,"11/7/2000",366,-6,48.4,47.9,0.5
2000,"1999-11-08",40,50,"11/7/2000",365,-10,48.4,47.9,0.5
2000,"1999-11-11",42,52,"11/7/2000",362,-10,48.4,47.9,0.5
2000,"1999-11-15",37,51,"11/7/2000",358,-14,48.4,47.9,0.5
2000,"1999-11-15",39,50,"11/7/2000",358,-11,48.4,47.9,0.5
2000,"1999-11-15",40,53,"11/7/2000",358,-13,48.4,47.9,0.5
2000,"1999-11-15",41,52,"11/7/2000",358,-11,48.4,47.9,0.5
2000,"1999-11-15",41,50,"11/7/2000",358,-9,48.4,47.9,0.5
2000,"1999-11-15",41,53,"11/7/2000",358,-12,48.4,47.9,0.5
2000,"1999-11-15",40,54,"11/7/2000",358,-14,48.4,47.9,0.5
2000,"1999-11-15",39,53,"11/7/2000",358,-14,48.4,47.9,0.5
2000,"1999-11-15",40,51,"11/7/2000",358,-11,48.4,47.9,0.5
2000,"1999-11-21",39,56,"11/7/2000",352,-17,48.4,47.9,0.5
2000,"1999-11-21",40,56,"11/7/2000",352,-16,48.4,47.9,0.5
2000,"1999-12-07",36,53,"11/7/2000",336,-17,48.4,47.9,0.5
2000,"1999-12-07",32,48,"11/7/2000",336,-16,48.4,47.9,0.5
2000,"1999-12-12",39,50,"11/7/2000",331,-11,48.4,47.9,0.5
2000,"1999-12-12",38,47,"11/7/2000",331,-9,48.4,47.9,0.5
2000,"1999-12-12",37,44,"11/7/2000",331,-7,48.4,47.9,0.5
2000,"1999-12-12",35,48,"11/7/2000",331,-13,48.4,47.9,0.5
2000,"1999-12-12",42,55,"11/7/2000",331,-13,48.4,47.9,0.5
2000,"1999-12-14",36,45,"11/7/2000",329,-9,48.4,47.9,0.5
2000,"1999-12-15",39,55,"11/7/2000",328,-16,48.4,47.9,0.5
2000,"2000-01-10",43,52,"11/7/2000",302,-9,48.4,47.9,0.5
2000,"2000-01-10",44,51,"11/7/2000",302,-7,48.4,47.9,0.5
2000,"2000-01-10",41,49,"11/7/2000",302,-8,48.4,47.9,0.5
2000,"2000-01-10",42,50,"11/7/2000",302,-8,48.4,47.9,0.5
2000,"2000-01-10",42,48,"11/7/2000",302,-6,48.4,47.9,0.5
2000,"2000-01-10",44,49,"11/7/2000",302,-5,48.4,47.9,0.5
2000,"2000-01-13",45,50,"11/7/2000",299,-5,48.4,47.9,0.5
2000,"2000-01-13",36,51,"11/7/2000",299,-15,48.4,47.9,0.5
2000,"2000-01-14",40,53,"11/7/2000",298,-13,48.4,47.9,0.5
2000,"2000-01-16",41,51,"11/7/2000",296,-10,48.4,47.9,0.5
2000,"2000-01-16",42,53,"11/7/2000",296,-11,48.4,47.9,0.5
2000,"2000-01-16",39,49,"11/7/2000",296,-10,48.4,47.9,0.5
2000,"2000-01-16",38,46,"11/7/2000",296,-8,48.4,47.9,0.5
2000,"2000-01-19",45,49,"11/7/2000",293,-4,48.4,47.9,0.5
2000,"2000-01-26",44,47,"11/7/2000",286,-3,48.4,47.9,0.5
2000,"2000-01-26",43,43,"11/7/2000",286,0,48.4,47.9,0.5
2000,"2000-01-26",44,51,"11/7/2000",286,-7,48.4,47.9,0.5
2000,"2000-01-27",39,47,"11/7/2000",285,-8,48.4,47.9,0.5
2000,"2000-01-27",39,44,"11/7/2000",285,-5,48.4,47.9,0.5
2000,"2000-01-27",38,45,"11/7/2000",285,-7,48.4,47.9,0.5
2000,"2000-01-27",37,44,"11/7/2000",285,-7,48.4,47.9,0.5
2000,"2000-02-03",42,50,"11/7/2000",278,-8,48.4,47.9,0.5
2000,"2000-02-04",45,47,"11/7/2000",277,-2,48.4,47.9,0.5
2000,"2000-02-06",45,49,"11/7/2000",275,-4,48.4,47.9,0.5
2000,"2000-02-06",45,46,"11/7/2000",275,-1,48.4,47.9,0.5
2000,"2000-02-06",45,51,"11/7/2000",275,-6,48.4,47.9,0.5
2000,"2000-02-06",44,53,"11/7/2000",275,-9,48.4,47.9,0.5
2000,"2000-02-06",45,43,"11/7/2000",275,2,48.4,47.9,0.5
2000,"2000-02-10",43,47,"11/7/2000",271,-4,48.4,47.9,0.5
2000,"2000-02-10",39,48,"11/7/2000",271,-9,48.4,47.9,0.5
2000,"2000-02-14",44,45,"11/7/2000",267,-1,48.4,47.9,0.5
2000,"2000-02-15",45,50,"11/7/2000",266,-5,48.4,47.9,0.5
2000,"2000-02-15",46,48,"11/7/2000",266,-2,48.4,47.9,0.5
2000,"2000-02-21",45,50,"11/7/2000",260,-5,48.4,47.9,0.5
2000,"2000-02-21",44,51,"11/7/2000",260,-7,48.4,47.9,0.5
2000,"2000-02-24",40,49,"11/7/2000",257,-9,48.4,47.9,0.5
2000,"2000-02-24",39,49,"11/7/2000",257,-10,48.4,47.9,0.5
2000,"2000-02-25",41,50,"11/7/2000",256,-9,48.4,47.9,0.5
2000,"2000-02-27",44,50,"11/7/2000",254,-6,48.4,47.9,0.5
2000,"2000-02-27",43,52,"11/7/2000",254,-9,48.4,47.9,0.5
2000,"2000-03-05",32,37,"11/7/2000",247,-5,48.4,47.9,0.5
2000,"2000-03-05",33,34,"11/7/2000",247,-1,48.4,47.9,0.5
2000,"2000-03-05",46,46,"11/7/2000",247,0,48.4,47.9,0.5
2000,"2000-03-05",44,42,"11/7/2000",247,2,48.4,47.9,0.5
2000,"2000-03-08",43,40,"11/7/2000",244,3,48.4,47.9,0.5
2000,"2000-03-08",42,40,"11/7/2000",244,2,48.4,47.9,0.5
2000,"2000-03-08",34,32,"11/7/2000",244,2,48.4,47.9,0.5
2000,"2000-03-09",42,46,"11/7/2000",243,-4,48.4,47.9,0.5
2000,"2000-03-09",41,45,"11/7/2000",243,-4,48.4,47.9,0.5
2000,"2000-03-09",34,38,"11/7/2000",243,-4,48.4,47.9,0.5
2000,"2000-03-09",48,46,"11/7/2000",243,2,48.4,47.9,0.5
2000,"2000-03-09",46,43,"11/7/2000",243,3,48.4,47.9,0.5
2000,"2000-03-09",40,39,"11/7/2000",243,1,48.4,47.9,0.5
2000,"2000-03-10",42,45,"11/7/2000",242,-3,48.4,47.9,0.5
2000,"2000-03-10",44,47,"11/7/2000",242,-3,48.4,47.9,0.5
2000,"2000-03-10",28,35,"11/7/2000",242,-7,48.4,47.9,0.5
2000,"2000-03-10",38,41,"11/7/2000",242,-3,48.4,47.9,0.5
2000,"2000-03-10",41,43,"11/7/2000",242,-2,48.4,47.9,0.5
2000,"2000-03-11",48,45,"11/7/2000",241,3,48.4,47.9,0.5
2000,"2000-03-11",46,45,"11/7/2000",241,1,48.4,47.9,0.5
2000,"2000-03-11",37,37,"11/7/2000",241,0,48.4,47.9,0.5
2000,"2000-03-12",43,47,"11/7/2000",240,-4,48.4,47.9,0.5
2000,"2000-03-12",43,49,"11/7/2000",240,-6,48.4,47.9,0.5
2000,"2000-03-12",44,49,"11/7/2000",240,-5,48.4,47.9,0.5
2000,"2000-03-12",44,45,"11/7/2000",240,-1,48.4,47.9,0.5
2000,"2000-03-13",44,48,"11/7/2000",239,-4,48.4,47.9,0.5
2000,"2000-03-16",49,43,"11/7/2000",236,6,48.4,47.9,0.5
2000,"2000-03-19",43,46,"11/7/2000",233,-3,48.4,47.9,0.5
2000,"2000-03-19",41,43,"11/7/2000",233,-2,48.4,47.9,0.5
2000,"2000-03-19",31,36,"11/7/2000",233,-5,48.4,47.9,0.5
2000,"2000-03-21",42,49,"11/7/2000",231,-7,48.4,47.9,0.5
2000,"2000-03-21",41,46,"11/7/2000",231,-5,48.4,47.9,0.5
2000,"2000-03-23",42,47,"11/7/2000",229,-5,48.4,47.9,0.5
2000,"2000-03-23",30,35,"11/7/2000",229,-5,48.4,47.9,0.5
2000,"2000-03-23",37,39,"11/7/2000",229,-2,48.4,47.9,0.5
2000,"2000-03-23",42,44,"11/7/2000",229,-2,48.4,47.9,0.5
2000,"2000-03-24",42,44,"11/7/2000",228,-2,48.4,47.9,0.5
2000,"2000-04-02",45,46,"11/7/2000",219,-1,48.4,47.9,0.5
2000,"2000-04-02",45,44,"11/7/2000",219,1,48.4,47.9,0.5
2000,"2000-04-02",47,46,"11/7/2000",219,1,48.4,47.9,0.5
2000,"2000-04-04",39,43,"11/7/2000",217,-4,48.4,47.9,0.5
2000,"2000-04-04",37,43,"11/7/2000",217,-6,48.4,47.9,0.5
2000,"2000-04-04",42,46,"11/7/2000",217,-4,48.4,47.9,0.5
2000,"2000-04-04",41,44,"11/7/2000",217,-3,48.4,47.9,0.5
2000,"2000-04-04",39,43,"11/7/2000",217,-4,48.4,47.9,0.5
2000,"2000-04-05",44,47,"11/7/2000",216,-3,48.4,47.9,0.5
2000,"2000-04-05",43,44,"11/7/2000",216,-1,48.4,47.9,0.5
2000,"2000-04-06",37,45,"11/7/2000",215,-8,48.4,47.9,0.5
2000,"2000-04-06",32,40,"11/7/2000",215,-8,48.4,47.9,0.5
2000,"2000-04-07",44,44,"11/7/2000",214,0,48.4,47.9,0.5
2000,"2000-04-09",37,44,"11/7/2000",212,-7,48.4,47.9,0.5
2000,"2000-04-09",41,50,"11/7/2000",212,-9,48.4,47.9,0.5
2000,"2000-04-09",41,48,"11/7/2000",212,-7,48.4,47.9,0.5
2000,"2000-04-09",42,48,"11/7/2000",212,-6,48.4,47.9,0.5
2000,"2000-04-09",40,45,"11/7/2000",212,-5,48.4,47.9,0.5
2000,"2000-04-14",42,44,"11/7/2000",207,-2,48.4,47.9,0.5
2000,"2000-04-17",41,43,"11/7/2000",204,-2,48.4,47.9,0.5
2000,"2000-04-18",31,41,"11/7/2000",203,-10,48.4,47.9,0.5
2000,"2000-04-18",36,43,"11/7/2000",203,-7,48.4,47.9,0.5
2000,"2000-04-27",31,37,"11/7/2000",194,-6,48.4,47.9,0.5
2000,"2000-04-27",38,47,"11/7/2000",194,-9,48.4,47.9,0.5
2000,"2000-04-30",44,49,"11/7/2000",191,-5,48.4,47.9,0.5
2000,"2000-04-30",41,47,"11/7/2000",191,-6,48.4,47.9,0.5
2000,"2000-05-01",39,43,"11/7/2000",190,-4,48.4,47.9,0.5
2000,"2000-05-01",37,41,"11/7/2000",190,-4,48.4,47.9,0.5
2000,"2000-05-01",41,46,"11/7/2000",190,-5,48.4,47.9,0.5
2000,"2000-05-01",31,35,"11/7/2000",190,-4,48.4,47.9,0.5
2000,"2000-05-07",39,47,"11/7/2000",184,-8,48.4,47.9,0.5
2000,"2000-05-07",43,51,"11/7/2000",184,-8,48.4,47.9,0.5
2000,"2000-05-10",44,49,"11/7/2000",181,-5,48.4,47.9,0.5
2000,"2000-05-10",39,45,"11/7/2000",181,-6,48.4,47.9,0.5
2000,"2000-05-11",33,40,"11/7/2000",180,-7,48.4,47.9,0.5
2000,"2000-05-11",40,44,"11/7/2000",180,-4,48.4,47.9,0.5
2000,"2000-05-11",31,35,"11/7/2000",180,-4,48.4,47.9,0.5
2000,"2000-05-13",39,47,"11/7/2000",178,-8,48.4,47.9,0.5
2000,"2000-05-13",39,42,"11/7/2000",178,-3,48.4,47.9,0.5
2000,"2000-05-13",41,46,"11/7/2000",178,-5,48.4,47.9,0.5
2000,"2000-05-16",45,46,"11/7/2000",175,-1,48.4,47.9,0.5
2000,"2000-05-24",41,43,"11/7/2000",167,-2,48.4,47.9,0.5
2000,"2000-05-24",35,40,"11/7/2000",167,-5,48.4,47.9,0.5
2000,"2000-05-24",42,49,"11/7/2000",167,-7,48.4,47.9,0.5
2000,"2000-05-25",35,42,"11/7/2000",166,-7,48.4,47.9,0.5
2000,"2000-05-25",39,49,"11/7/2000",166,-10,48.4,47.9,0.5
2000,"2000-06-02",43,44,"11/7/2000",158,-1,48.4,47.9,0.5
2000,"2000-06-04",38,41,"11/7/2000",156,-3,48.4,47.9,0.5
2000,"2000-06-04",42,46,"11/7/2000",156,-4,48.4,47.9,0.5
2000,"2000-06-04",40,44,"11/7/2000",156,-4,48.4,47.9,0.5
2000,"2000-06-05",37,47,"11/7/2000",155,-10,48.4,47.9,0.5
2000,"2000-06-07",44,48,"11/7/2000",153,-4,48.4,47.9,0.5
2000,"2000-06-07",41,46,"11/7/2000",153,-5,48.4,47.9,0.5
2000,"2000-06-08",32,39,"11/7/2000",152,-7,48.4,47.9,0.5
2000,"2000-06-08",38,46,"11/7/2000",152,-8,48.4,47.9,0.5
2000,"2000-06-11",44,45,"11/7/2000",149,-1,48.4,47.9,0.5
2000,"2000-06-11",42,44,"11/7/2000",149,-2,48.4,47.9,0.5
2000,"2000-06-11",45,49,"11/7/2000",149,-4,48.4,47.9,0.5
2000,"2000-06-11",41,47,"11/7/2000",149,-6,48.4,47.9,0.5
2000,"2000-06-13",40,50,"11/7/2000",147,-10,48.4,47.9,0.5
2000,"2000-06-13",40,52,"11/7/2000",147,-12,48.4,47.9,0.5
2000,"2000-06-18",41,49,"11/7/2000",142,-8,48.4,47.9,0.5
2000,"2000-06-18",38,43,"11/7/2000",142,-5,48.4,47.9,0.5
2000,"2000-06-20",36,42,"11/7/2000",140,-6,48.4,47.9,0.5
2000,"2000-06-20",39,46,"11/7/2000",140,-7,48.4,47.9,0.5
2000,"2000-06-21",46,45,"11/7/2000",139,1,48.4,47.9,0.5
2000,"2000-06-21",42,41,"11/7/2000",139,1,48.4,47.9,0.5
2000,"2000-06-23",40,42,"11/7/2000",137,-2,48.4,47.9,0.5
2000,"2000-06-23",45,45,"11/7/2000",137,0,48.4,47.9,0.5
2000,"2000-06-25",38,50,"11/7/2000",135,-12,48.4,47.9,0.5
2000,"2000-06-29",40,44,"11/7/2000",131,-4,48.4,47.9,0.5
2000,"2000-06-29",37,42,"11/7/2000",131,-5,48.4,47.9,0.5
2000,"2000-06-30",35,42,"11/7/2000",130,-7,48.4,47.9,0.5
2000,"2000-07-09",41,50,"11/7/2000",121,-9,48.4,47.9,0.5
2000,"2000-07-09",44,45,"11/7/2000",121,-1,48.4,47.9,0.5
2000,"2000-07-10",41,43,"11/7/2000",120,-2,48.4,47.9,0.5
2000,"2000-07-10",35,39,"11/7/2000",120,-4,48.4,47.9,0.5
2000,"2000-07-13",40,46,"11/7/2000",117,-6,48.4,47.9,0.5
2000,"2000-07-13",36,44,"11/7/2000",117,-8,48.4,47.9,0.5
2000,"2000-07-13",37,43,"11/7/2000",117,-6,48.4,47.9,0.5
2000,"2000-07-16",41,43,"11/7/2000",114,-2,48.4,47.9,0.5
2000,"2000-07-16",37,42,"11/7/2000",114,-5,48.4,47.9,0.5
2000,"2000-07-16",45,47,"11/7/2000",114,-2,48.4,47.9,0.5
2000,"2000-07-16",43,45,"11/7/2000",114,-2,48.4,47.9,0.5
2000,"2000-07-16",46,48,"11/7/2000",114,-2,48.4,47.9,0.5
2000,"2000-07-16",39,41,"11/7/2000",114,-2,48.4,47.9,0.5
2000,"2000-07-16",45,44,"11/7/2000",114,1,48.4,47.9,0.5
2000,"2000-07-17",37,43,"11/7/2000",113,-6,48.4,47.9,0.5
2000,"2000-07-17",41,45,"11/7/2000",113,-4,48.4,47.9,0.5
2000,"2000-07-23",38,44,"11/7/2000",107,-6,48.4,47.9,0.5
2000,"2000-07-23",41,48,"11/7/2000",107,-7,48.4,47.9,0.5
2000,"2000-07-24",41,49,"11/7/2000",106,-8,48.4,47.9,0.5
2000,"2000-07-24",45,49,"11/7/2000",106,-4,48.4,47.9,0.5
2000,"2000-07-26",39,50,"11/7/2000",104,-11,48.4,47.9,0.5
2000,"2000-07-26",40,54,"11/7/2000",104,-14,48.4,47.9,0.5
2000,"2000-08-11",42,45,"11/7/2000",88,-3,48.4,47.9,0.5
2000,"2000-08-11",43,46,"11/7/2000",88,-3,48.4,47.9,0.5
2000,"2000-08-11",40,46,"11/7/2000",88,-6,48.4,47.9,0.5
2000,"2000-08-11",39,44,"11/7/2000",88,-5,48.4,47.9,0.5
2000,"2000-08-11",38,48,"11/7/2000",88,-10,48.4,47.9,0.5
2000,"2000-08-11",43,51,"11/7/2000",88,-8,48.4,47.9,0.5
2000,"2000-08-12",39,55,"11/7/2000",87,-16,48.4,47.9,0.5
2000,"2000-08-14",38,47,"11/7/2000",85,-9,48.4,47.9,0.5
2000,"2000-08-14",41,48,"11/7/2000",85,-7,48.4,47.9,0.5
2000,"2000-08-15",40,49,"11/7/2000",84,-9,48.4,47.9,0.5
2000,"2000-08-15",37,48,"11/7/2000",84,-11,48.4,47.9,0.5
2000,"2000-08-16",37,48,"11/7/2000",83,-11,48.4,47.9,0.5
2000,"2000-08-16",40,50,"11/7/2000",83,-10,48.4,47.9,0.5
2000,"2000-08-17",40,45,"11/7/2000",82,-5,48.4,47.9,0.5
2000,"2000-08-17",42,47,"11/7/2000",82,-5,48.4,47.9,0.5
2000,"2000-08-17",46,43,"11/7/2000",82,3,48.4,47.9,0.5
2000,"2000-08-18",52,44,"11/7/2000",81,8,48.4,47.9,0.5
2000,"2000-08-18",48,42,"11/7/2000",81,6,48.4,47.9,0.5
2000,"2000-08-19",47,46,"11/7/2000",80,1,48.4,47.9,0.5
2000,"2000-08-19",49,49,"11/7/2000",80,0,48.4,47.9,0.5
2000,"2000-08-19",48,44,"11/7/2000",80,4,48.4,47.9,0.5
2000,"2000-08-20",53,45,"11/7/2000",79,8,48.4,47.9,0.5
2000,"2000-08-20",50,45,"11/7/2000",79,5,48.4,47.9,0.5
2000,"2000-08-20",48,44,"11/7/2000",79,4,48.4,47.9,0.5
2000,"2000-08-20",46,44,"11/7/2000",79,2,48.4,47.9,0.5
2000,"2000-08-20",48,45,"11/7/2000",79,3,48.4,47.9,0.5
2000,"2000-08-20",45,44,"11/7/2000",79,1,48.4,47.9,0.5
2000,"2000-08-20",44,41,"11/7/2000",79,3,48.4,47.9,0.5
2000,"2000-08-20",47,43,"11/7/2000",79,4,48.4,47.9,0.5
2000,"2000-08-24",45,40,"11/7/2000",75,5,48.4,47.9,0.5
2000,"2000-08-24",45,38,"11/7/2000",75,7,48.4,47.9,0.5
2000,"2000-08-24",46,42,"11/7/2000",75,4,48.4,47.9,0.5
2000,"2000-08-24",44,40,"11/7/2000",75,4,48.4,47.9,0.5
2000,"2000-08-25",46,42,"11/7/2000",74,4,48.4,47.9,0.5
2000,"2000-08-25",49,45,"11/7/2000",74,4,48.4,47.9,0.5
2000,"2000-08-27",45,46,"11/7/2000",72,-1,48.4,47.9,0.5
2000,"2000-08-27",48,41,"11/7/2000",72,7,48.4,47.9,0.5
2000,"2000-08-28",44,43,"11/7/2000",71,1,48.4,47.9,0.5
2000,"2000-08-31",49,39,"11/7/2000",68,10,48.4,47.9,0.5
2000,"2000-08-31",53,41,"11/7/2000",68,12,48.4,47.9,0.5
2000,"2000-09-06",47,49,"11/7/2000",62,-2,48.4,47.9,0.5
2000,"2000-09-06",49,43,"11/7/2000",62,6,48.4,47.9,0.5
2000,"2000-09-06",47,41,"11/7/2000",62,6,48.4,47.9,0.5
2000,"2000-09-06",47,44,"11/7/2000",62,3,48.4,47.9,0.5
2000,"2000-09-06",45,45,"11/7/2000",62,0,48.4,47.9,0.5
2000,"2000-09-06",49,46,"11/7/2000",62,3,48.4,47.9,0.5
2000,"2000-09-06",46,40,"11/7/2000",62,6,48.4,47.9,0.5
2000,"2000-09-06",47,47,"11/7/2000",62,0,48.4,47.9,0.5
2000,"2000-09-07",44,43,"11/7/2000",61,1,48.4,47.9,0.5
2000,"2000-09-07",41,41,"11/7/2000",61,0,48.4,47.9,0.5
2000,"2000-09-07",46,42,"11/7/2000",61,4,48.4,47.9,0.5
2000,"2000-09-07",46,43,"11/7/2000",61,3,48.4,47.9,0.5
2000,"2000-09-07",43,43,"11/7/2000",61,0,48.4,47.9,0.5
2000,"2000-09-07",46,43,"11/7/2000",61,3,48.4,47.9,0.5
2000,"2000-09-07",45,43,"11/7/2000",61,2,48.4,47.9,0.5
2000,"2000-09-08",46,43,"11/7/2000",60,3,48.4,47.9,0.5
2000,"2000-09-08",45,46,"11/7/2000",60,-1,48.4,47.9,0.5
2000,"2000-09-08",49,41,"11/7/2000",60,8,48.4,47.9,0.5
2000,"2000-09-08",47,39,"11/7/2000",60,8,48.4,47.9,0.5
2000,"2000-09-09",47,41,"11/7/2000",59,6,48.4,47.9,0.5
2000,"2000-09-09",47,44,"11/7/2000",59,3,48.4,47.9,0.5
2000,"2000-09-10",43,42,"11/7/2000",58,1,48.4,47.9,0.5
2000,"2000-09-10",41,40,"11/7/2000",58,1,48.4,47.9,0.5
2000,"2000-09-10",47,38,"11/7/2000",58,9,48.4,47.9,0.5
2000,"2000-09-10",45,42,"11/7/2000",58,3,48.4,47.9,0.5
2000,"2000-09-10",49,40,"11/7/2000",58,9,48.4,47.9,0.5
2000,"2000-09-10",49,42,"11/7/2000",58,7,48.4,47.9,0.5
2000,"2000-09-11",41,40,"11/7/2000",57,1,48.4,47.9,0.5
2000,"2000-09-11",44,42,"11/7/2000",57,2,48.4,47.9,0.5
2000,"2000-09-11",47,41,"11/7/2000",57,6,48.4,47.9,0.5
2000,"2000-09-11",48,42,"11/7/2000",57,6,48.4,47.9,0.5
2000,"2000-09-12",38,41,"11/7/2000",56,-3,48.4,47.9,0.5
2000,"2000-09-12",46,40,"11/7/2000",56,6,48.4,47.9,0.5
2000,"2000-09-12",50,43,"11/7/2000",56,7,48.4,47.9,0.5
2000,"2000-09-12",42,43,"11/7/2000",56,-1,48.4,47.9,0.5
2000,"2000-09-12",49,39,"11/7/2000",56,10,48.4,47.9,0.5
2000,"2000-09-12",49,41,"11/7/2000",56,8,48.4,47.9,0.5
2000,"2000-09-13",39,41,"11/7/2000",55,-2,48.4,47.9,0.5
2000,"2000-09-13",42,43,"11/7/2000",55,-1,48.4,47.9,0.5
2000,"2000-09-13",49,39,"11/7/2000",55,10,48.4,47.9,0.5
2000,"2000-09-13",49,42,"11/7/2000",55,7,48.4,47.9,0.5
2000,"2000-09-14",39,41,"11/7/2000",54,-2,48.4,47.9,0.5
2000,"2000-09-14",42,42,"11/7/2000",54,0,48.4,47.9,0.5
2000,"2000-09-14",48,40,"11/7/2000",54,8,48.4,47.9,0.5
2000,"2000-09-14",49,42,"11/7/2000",54,7,48.4,47.9,0.5
2000,"2000-09-15",48,40,"11/7/2000",53,8,48.4,47.9,0.5
2000,"2000-09-15",48,42,"11/7/2000",53,6,48.4,47.9,0.5
2000,"2000-09-16",49,38,"11/7/2000",52,11,48.4,47.9,0.5
2000,"2000-09-16",49,41,"11/7/2000",52,8,48.4,47.9,0.5
2000,"2000-09-16",47,41,"11/7/2000",52,6,48.4,47.9,0.5
2000,"2000-09-17",37,41,"11/7/2000",51,-4,48.4,47.9,0.5
2000,"2000-09-17",40,43,"11/7/2000",51,-3,48.4,47.9,0.5
2000,"2000-09-17",50,39,"11/7/2000",51,11,48.4,47.9,0.5
2000,"2000-09-17",48,43,"11/7/2000",51,5,48.4,47.9,0.5
2000,"2000-09-17",46,44,"11/7/2000",51,2,48.4,47.9,0.5
2000,"2000-09-18",39,40,"11/7/2000",50,-1,48.4,47.9,0.5
2000,"2000-09-18",41,42,"11/7/2000",50,-1,48.4,47.9,0.5
2000,"2000-09-18",49,40,"11/7/2000",50,9,48.4,47.9,0.5
2000,"2000-09-18",48,44,"11/7/2000",50,4,48.4,47.9,0.5
2000,"2000-09-19",39,42,"11/7/2000",49,-3,48.4,47.9,0.5
2000,"2000-09-19",42,43,"11/7/2000",49,-1,48.4,47.9,0.5
2000,"2000-09-19",41,41,"11/7/2000",49,0,48.4,47.9,0.5
2000,"2000-09-19",50,40,"11/7/2000",49,10,48.4,47.9,0.5
2000,"2000-09-19",49,43,"11/7/2000",49,6,48.4,47.9,0.5
2000,"2000-09-20",38,43,"11/7/2000",48,-5,48.4,47.9,0.5
2000,"2000-09-20",41,45,"11/7/2000",48,-4,48.4,47.9,0.5
2000,"2000-09-20",50,39,"11/7/2000",48,11,48.4,47.9,0.5
2000,"2000-09-20",51,41,"11/7/2000",48,10,48.4,47.9,0.5
2000,"2000-09-20",45,41,"11/7/2000",48,4,48.4,47.9,0.5
2000,"2000-09-21",41,42,"11/7/2000",47,-1,48.4,47.9,0.5
2000,"2000-09-21",49,41,"11/7/2000",47,8,48.4,47.9,0.5
2000,"2000-09-21",50,42,"11/7/2000",47,8,48.4,47.9,0.5
2000,"2000-09-22",47,43,"11/7/2000",46,4,48.4,47.9,0.5
2000,"2000-09-22",48,45,"11/7/2000",46,3,48.4,47.9,0.5
2000,"2000-09-23",42,44,"11/7/2000",45,-2,48.4,47.9,0.5
2000,"2000-09-23",46,43,"11/7/2000",45,3,48.4,47.9,0.5
2000,"2000-09-23",46,47,"11/7/2000",45,-1,48.4,47.9,0.5
2000,"2000-09-24",41,44,"11/7/2000",44,-3,48.4,47.9,0.5
2000,"2000-09-24",46,42,"11/7/2000",44,4,48.4,47.9,0.5
2000,"2000-09-24",44,47,"11/7/2000",44,-3,48.4,47.9,0.5
2000,"2000-09-25",40,43,"11/7/2000",43,-3,48.4,47.9,0.5
2000,"2000-09-25",43,42,"11/7/2000",43,1,48.4,47.9,0.5
2000,"2000-09-25",48,40,"11/7/2000",43,8,48.4,47.9,0.5
2000,"2000-09-25",44,46,"11/7/2000",43,-2,48.4,47.9,0.5
2000,"2000-09-25",42,48,"11/7/2000",43,-6,48.4,47.9,0.5
2000,"2000-09-25",48,48,"11/7/2000",43,0,48.4,47.9,0.5
2000,"2000-09-26",41,42,"11/7/2000",42,-1,48.4,47.9,0.5
2000,"2000-09-26",47,41,"11/7/2000",42,6,48.4,47.9,0.5
2000,"2000-09-26",44,46,"11/7/2000",42,-2,48.4,47.9,0.5
2000,"2000-09-27",40,43,"11/7/2000",41,-3,48.4,47.9,0.5
2000,"2000-09-27",46,42,"11/7/2000",41,4,48.4,47.9,0.5
2000,"2000-09-27",46,46,"11/7/2000",41,0,48.4,47.9,0.5
2000,"2000-09-28",40,42,"11/7/2000",40,-2,48.4,47.9,0.5
2000,"2000-09-28",47,41,"11/7/2000",40,6,48.4,47.9,0.5
2000,"2000-09-28",44,46,"11/7/2000",40,-2,48.4,47.9,0.5
2000,"2000-09-28",44,43,"11/7/2000",40,1,48.4,47.9,0.5
2000,"2000-09-29",46,42,"11/7/2000",39,4,48.4,47.9,0.5
2000,"2000-09-29",46,44,"11/7/2000",39,2,48.4,47.9,0.5
2000,"2000-09-29",44,44,"11/7/2000",39,0,48.4,47.9,0.5
2000,"2000-09-30",47,44,"11/7/2000",38,3,48.4,47.9,0.5
2000,"2000-09-30",45,42,"11/7/2000",38,3,48.4,47.9,0.5
2000,"2000-09-30",45,45,"11/7/2000",38,0,48.4,47.9,0.5
2000,"2000-09-30",45,43,"11/7/2000",38,2,48.4,47.9,0.5
2000,"2000-10-01",41,41,"11/7/2000",37,0,48.4,47.9,0.5
2000,"2000-10-01",45,47,"11/7/2000",37,-2,48.4,47.9,0.5
2000,"2000-10-01",46,43,"11/7/2000",37,3,48.4,47.9,0.5
2000,"2000-10-01",47,40,"11/7/2000",37,7,48.4,47.9,0.5
2000,"2000-10-01",45,45,"11/7/2000",37,0,48.4,47.9,0.5
2000,"2000-10-01",45,41,"11/7/2000",37,4,48.4,47.9,0.5
2000,"2000-10-01",48,46,"11/7/2000",37,2,48.4,47.9,0.5
2000,"2000-10-02",41,42,"11/7/2000",36,-1,48.4,47.9,0.5
2000,"2000-10-02",47,39,"11/7/2000",36,8,48.4,47.9,0.5
2000,"2000-10-02",46,44,"11/7/2000",36,2,48.4,47.9,0.5
2000,"2000-10-02",46,40,"11/7/2000",36,6,48.4,47.9,0.5
2000,"2000-10-03",41,43,"11/7/2000",35,-2,48.4,47.9,0.5
2000,"2000-10-03",46,41,"11/7/2000",35,5,48.4,47.9,0.5
2000,"2000-10-03",48,38,"11/7/2000",35,10,48.4,47.9,0.5
2000,"2000-10-03",49,41,"11/7/2000",35,8,48.4,47.9,0.5
2000,"2000-10-03",46,44,"11/7/2000",35,2,48.4,47.9,0.5
2000,"2000-10-04",41,43,"11/7/2000",34,-2,48.4,47.9,0.5
2000,"2000-10-04",48,39,"11/7/2000",34,9,48.4,47.9,0.5
2000,"2000-10-04",51,40,"11/7/2000",34,11,48.4,47.9,0.5
2000,"2000-10-04",46,40,"11/7/2000",34,6,48.4,47.9,0.5
2000,"2000-10-05",41,43,"11/7/2000",33,-2,48.4,47.9,0.5
2000,"2000-10-05",45,41,"11/7/2000",33,4,48.4,47.9,0.5
2000,"2000-10-05",45,44,"11/7/2000",33,1,48.4,47.9,0.5
2000,"2000-10-05",46,41,"11/7/2000",33,5,48.4,47.9,0.5
2000,"2000-10-06",43,43,"11/7/2000",32,0,48.4,47.9,0.5
2000,"2000-10-06",41,48,"11/7/2000",32,-7,48.4,47.9,0.5
2000,"2000-10-06",45,41,"11/7/2000",32,4,48.4,47.9,0.5
2000,"2000-10-07",41,49,"11/7/2000",31,-8,48.4,47.9,0.5
2000,"2000-10-07",42,44,"11/7/2000",31,-2,48.4,47.9,0.5
2000,"2000-10-07",44,42,"11/7/2000",31,2,48.4,47.9,0.5
2000,"2000-10-08",41,44,"11/7/2000",30,-3,48.4,47.9,0.5
2000,"2000-10-08",42,43,"11/7/2000",30,-1,48.4,47.9,0.5
2000,"2000-10-08",44,45,"11/7/2000",30,-1,48.4,47.9,0.5
2000,"2000-10-08",44,43,"11/7/2000",30,1,48.4,47.9,0.5
2000,"2000-10-08",43,42,"11/7/2000",30,1,48.4,47.9,0.5
2000,"2000-10-08",42,50,"11/7/2000",30,-8,48.4,47.9,0.5
2000,"2000-10-08",43,44,"11/7/2000",30,-1,48.4,47.9,0.5
2000,"2000-10-09",41,43,"11/7/2000",29,-2,48.4,47.9,0.5
2000,"2000-10-09",46,44,"11/7/2000",29,2,48.4,47.9,0.5
2000,"2000-10-09",43,47,"11/7/2000",29,-4,48.4,47.9,0.5
2000,"2000-10-09",45,48,"11/7/2000",29,-3,48.4,47.9,0.5
2000,"2000-10-09",46,50,"11/7/2000",29,-4,48.4,47.9,0.5
2000,"2000-10-09",44,47,"11/7/2000",29,-3,48.4,47.9,0.5
2000,"2000-10-09",44,42,"11/7/2000",29,2,48.4,47.9,0.5
2000,"2000-10-09",42,43,"11/7/2000",29,-1,48.4,47.9,0.5
2000,"2000-10-10",40,44,"11/7/2000",28,-4,48.4,47.9,0.5
2000,"2000-10-10",40,41,"11/7/2000",28,-1,48.4,47.9,0.5
2000,"2000-10-10",42,43,"11/7/2000",28,-1,48.4,47.9,0.5
2000,"2000-10-10",45,45,"11/7/2000",28,0,48.4,47.9,0.5
2000,"2000-10-10",45,40,"11/7/2000",28,5,48.4,47.9,0.5
2000,"2000-10-10",46,43,"11/7/2000",28,3,48.4,47.9,0.5
2000,"2000-10-11",40,44,"11/7/2000",27,-4,48.4,47.9,0.5
2000,"2000-10-11",42,48,"11/7/2000",27,-6,48.4,47.9,0.5
2000,"2000-10-11",43,44,"11/7/2000",27,-1,48.4,47.9,0.5
2000,"2000-10-11",43,43,"11/7/2000",27,0,48.4,47.9,0.5
2000,"2000-10-11",41,46,"11/7/2000",27,-5,48.4,47.9,0.5
2000,"2000-10-12",39,43,"11/7/2000",26,-4,48.4,47.9,0.5
2000,"2000-10-12",44,47,"11/7/2000",26,-3,48.4,47.9,0.5
2000,"2000-10-12",44,44,"11/7/2000",26,0,48.4,47.9,0.5
2000,"2000-10-12",42,43,"11/7/2000",26,-1,48.4,47.9,0.5
2000,"2000-10-13",44,47,"11/7/2000",25,-3,48.4,47.9,0.5
2000,"2000-10-13",45,44,"11/7/2000",25,1,48.4,47.9,0.5
2000,"2000-10-13",41,44,"11/7/2000",25,-3,48.4,47.9,0.5
2000,"2000-10-14",43,48,"11/7/2000",24,-5,48.4,47.9,0.5
2000,"2000-10-14",43,45,"11/7/2000",24,-2,48.4,47.9,0.5
2000,"2000-10-14",41,43,"11/7/2000",24,-2,48.4,47.9,0.5
2000,"2000-10-15",40,43,"11/7/2000",23,-3,48.4,47.9,0.5
2000,"2000-10-15",42,43,"11/7/2000",23,-1,48.4,47.9,0.5
2000,"2000-10-15",44,48,"11/7/2000",23,-4,48.4,47.9,0.5
2000,"2000-10-15",43,43,"11/7/2000",23,0,48.4,47.9,0.5
2000,"2000-10-15",42,45,"11/7/2000",23,-3,48.4,47.9,0.5
2000,"2000-10-15",42,48,"11/7/2000",23,-6,48.4,47.9,0.5
2000,"2000-10-16",40,42,"11/7/2000",22,-2,48.4,47.9,0.5
2000,"2000-10-16",43,44,"11/7/2000",22,-1,48.4,47.9,0.5
2000,"2000-10-16",45,45,"11/7/2000",22,0,48.4,47.9,0.5
2000,"2000-10-16",44,41,"11/7/2000",22,3,48.4,47.9,0.5
2000,"2000-10-17",40,42,"11/7/2000",21,-2,48.4,47.9,0.5
2000,"2000-10-17",45,44,"11/7/2000",21,1,48.4,47.9,0.5
2000,"2000-10-17",44,39,"11/7/2000",21,5,48.4,47.9,0.5
2000,"2000-10-17",43,43,"11/7/2000",21,0,48.4,47.9,0.5
2000,"2000-10-18",44,48,"11/7/2000",20,-4,48.4,47.9,0.5
2000,"2000-10-18",40,44,"11/7/2000",20,-4,48.4,47.9,0.5
2000,"2000-10-18",39,49,"11/7/2000",20,-10,48.4,47.9,0.5
2000,"2000-10-18",41,44,"11/7/2000",20,-3,48.4,47.9,0.5
2000,"2000-10-18",43,44,"11/7/2000",20,-1,48.4,47.9,0.5
2000,"2000-10-18",43,45,"11/7/2000",20,-2,48.4,47.9,0.5
2000,"2000-10-19",39,44,"11/7/2000",19,-5,48.4,47.9,0.5
2000,"2000-10-19",43,48,"11/7/2000",19,-5,48.4,47.9,0.5
2000,"2000-10-19",44,44,"11/7/2000",19,0,48.4,47.9,0.5
2000,"2000-10-19",40,50,"11/7/2000",19,-10,48.4,47.9,0.5
2000,"2000-10-19",46,45,"11/7/2000",19,1,48.4,47.9,0.5
2000,"2000-10-20",45,47,"11/7/2000",18,-2,48.4,47.9,0.5
2000,"2000-10-20",40,51,"11/7/2000",18,-11,48.4,47.9,0.5
2000,"2000-10-20",44,45,"11/7/2000",18,-1,48.4,47.9,0.5
2000,"2000-10-21",41,45,"11/7/2000",17,-4,48.4,47.9,0.5
2000,"2000-10-21",41,50,"11/7/2000",17,-9,48.4,47.9,0.5
2000,"2000-10-21",45,47,"11/7/2000",17,-2,48.4,47.9,0.5
2000,"2000-10-22",38,46,"11/7/2000",16,-8,48.4,47.9,0.5
2000,"2000-10-22",41,43,"11/7/2000",16,-2,48.4,47.9,0.5
2000,"2000-10-22",45,45,"11/7/2000",16,0,48.4,47.9,0.5
2000,"2000-10-22",45,43,"11/7/2000",16,2,48.4,47.9,0.5
2000,"2000-10-22",42,44,"11/7/2000",16,-2,48.4,47.9,0.5
2000,"2000-10-22",44,46,"11/7/2000",16,-2,48.4,47.9,0.5
2000,"2000-10-22",46,47,"11/7/2000",16,-1,48.4,47.9,0.5
2000,"2000-10-22",48,48,"11/7/2000",16,0,48.4,47.9,0.5
2000,"2000-10-23",39,45,"11/7/2000",15,-6,48.4,47.9,0.5
2000,"2000-10-23",43,47,"11/7/2000",15,-4,48.4,47.9,0.5
2000,"2000-10-23",42,44,"11/7/2000",15,-2,48.4,47.9,0.5
2000,"2000-10-23",46,45,"11/7/2000",15,1,48.4,47.9,0.5
2000,"2000-10-23",46,43,"11/7/2000",15,3,48.4,47.9,0.5
2000,"2000-10-23",46,46,"11/7/2000",15,0,48.4,47.9,0.5
2000,"2000-10-23",49,48,"11/7/2000",15,1,48.4,47.9,0.5
2000,"2000-10-24",40,44,"11/7/2000",14,-4,48.4,47.9,0.5
2000,"2000-10-24",45,42,"11/7/2000",14,3,48.4,47.9,0.5
2000,"2000-10-24",43,48,"11/7/2000",14,-5,48.4,47.9,0.5
2000,"2000-10-24",44,45,"11/7/2000",14,-1,48.4,47.9,0.5
2000,"2000-10-24",45,47,"11/7/2000",14,-2,48.4,47.9,0.5
2000,"2000-10-24",48,49,"11/7/2000",14,-1,48.4,47.9,0.5
2000,"2000-10-25",40,45,"11/7/2000",13,-5,48.4,47.9,0.5
2000,"2000-10-25",42,49,"11/7/2000",13,-7,48.4,47.9,0.5
2000,"2000-10-25",43,46,"11/7/2000",13,-3,48.4,47.9,0.5
2000,"2000-10-25",45,48,"11/7/2000",13,-3,48.4,47.9,0.5
2000,"2000-10-25",48,50,"11/7/2000",13,-2,48.4,47.9,0.5
2000,"2000-10-25",45,43,"11/7/2000",13,2,48.4,47.9,0.5
2000,"2000-10-25",46,44,"11/7/2000",13,2,48.4,47.9,0.5
2000,"2000-10-26",40,43,"11/7/2000",12,-3,48.4,47.9,0.5
2000,"2000-10-26",47,50,"11/7/2000",12,-3,48.4,47.9,0.5
2000,"2000-10-26",39,52,"11/7/2000",12,-13,48.4,47.9,0.5
2000,"2000-10-26",41,48,"11/7/2000",12,-7,48.4,47.9,0.5
2000,"2000-10-26",45,48,"11/7/2000",12,-3,48.4,47.9,0.5
2000,"2000-10-26",45,43,"11/7/2000",12,2,48.4,47.9,0.5
2000,"2000-10-27",42,49,"11/7/2000",11,-7,48.4,47.9,0.5
2000,"2000-10-27",42,46,"11/7/2000",11,-4,48.4,47.9,0.5
2000,"2000-10-27",46,47,"11/7/2000",11,-1,48.4,47.9,0.5
2000,"2000-10-27",43,44,"11/7/2000",11,-1,48.4,47.9,0.5
2000,"2000-10-27",49,49,"11/7/2000",11,0,48.4,47.9,0.5
2000,"2000-10-28",46,47,"11/7/2000",10,-1,48.4,47.9,0.5
2000,"2000-10-28",49,49,"11/7/2000",10,0,48.4,47.9,0.5
2000,"2000-10-28",42,49,"11/7/2000",10,-7,48.4,47.9,0.5
2000,"2000-10-28",43,45,"11/7/2000",10,-2,48.4,47.9,0.5
2000,"2000-10-28",43,44,"11/7/2000",10,-1,48.4,47.9,0.5
2000,"2000-10-29",43,46,"11/7/2000",9,-3,48.4,47.9,0.5
2000,"2000-10-29",45,42,"11/7/2000",9,3,48.4,47.9,0.5
2000,"2000-10-29",47,48,"11/7/2000",9,-1,48.4,47.9,0.5
2000,"2000-10-29",49,45,"11/7/2000",9,4,48.4,47.9,0.5
2000,"2000-10-29",39,44,"11/7/2000",9,-5,48.4,47.9,0.5
2000,"2000-10-29",46,47,"11/7/2000",9,-1,48.4,47.9,0.5
2000,"2000-10-29",49,48,"11/7/2000",9,1,48.4,47.9,0.5
2000,"2000-10-29",42,45,"11/7/2000",9,-3,48.4,47.9,0.5
2000,"2000-10-29",44,47,"11/7/2000",9,-3,48.4,47.9,0.5
2000,"2000-10-29",44,47,"11/7/2000",9,-3,48.4,47.9,0.5
2000,"2000-10-29",43,44,"11/7/2000",9,-1,48.4,47.9,0.5
2000,"2000-10-30",38,45,"11/7/2000",8,-7,48.4,47.9,0.5
2000,"2000-10-30",42,45,"11/7/2000",8,-3,48.4,47.9,0.5
2000,"2000-10-30",44,47,"11/7/2000",8,-3,48.4,47.9,0.5
2000,"2000-10-30",46,48,"11/7/2000",8,-2,48.4,47.9,0.5
2000,"2000-10-30",48,49,"11/7/2000",8,-1,48.4,47.9,0.5
2000,"2000-10-31",40,45,"11/7/2000",7,-5,48.4,47.9,0.5
2000,"2000-10-31",41,46,"11/7/2000",7,-5,48.4,47.9,0.5
2000,"2000-10-31",43,48,"11/7/2000",7,-5,48.4,47.9,0.5
2000,"2000-10-31",43,47,"11/7/2000",7,-4,48.4,47.9,0.5
2000,"2000-10-31",45,49,"11/7/2000",7,-4,48.4,47.9,0.5
2000,"2000-10-31",47,50,"11/7/2000",7,-3,48.4,47.9,0.5
2000,"2000-10-31",45,45,"11/7/2000",7,0,48.4,47.9,0.5
2000,"2000-11-01",39,46,"11/7/2000",6,-7,48.4,47.9,0.5
2000,"2000-11-01",42,45,"11/7/2000",6,-3,48.4,47.9,0.5
2000,"2000-11-01",43,47,"11/7/2000",6,-4,48.4,47.9,0.5
2000,"2000-11-01",43,48,"11/7/2000",6,-5,48.4,47.9,0.5
2000,"2000-11-01",45,48,"11/7/2000",6,-3,48.4,47.9,0.5
2000,"2000-11-01",47,50,"11/7/2000",6,-3,48.4,47.9,0.5
2000,"2000-11-02",42,45,"11/7/2000",5,-3,48.4,47.9,0.5
2000,"2000-11-02",37,46,"11/7/2000",5,-9,48.4,47.9,0.5
2000,"2000-11-02",42,48,"11/7/2000",5,-6,48.4,47.9,0.5
2000,"2000-11-02",45,48,"11/7/2000",5,-3,48.4,47.9,0.5
2000,"2000-11-02",47,50,"11/7/2000",5,-3,48.4,47.9,0.5
2000,"2000-11-02",42,47,"11/7/2000",5,-5,48.4,47.9,0.5
2000,"2000-11-03",42,46,"11/7/2000",4,-4,48.4,47.9,0.5
2000,"2000-11-03",43,47,"11/7/2000",4,-4,48.4,47.9,0.5
2000,"2000-11-03",46,48,"11/7/2000",4,-2,48.4,47.9,0.5
2000,"2000-11-03",47,50,"11/7/2000",4,-3,48.4,47.9,0.5
2000,"2000-11-04",45,46,"11/7/2000",3,-1,48.4,47.9,0.5
2000,"2000-11-04",41,46,"11/7/2000",3,-5,48.4,47.9,0.5
2000,"2000-11-04",43,48,"11/7/2000",3,-5,48.4,47.9,0.5
2000,"2000-11-05",42,45,"11/7/2000",2,-3,48.4,47.9,0.5
2000,"2000-11-05",37,46,"11/7/2000",2,-9,48.4,47.9,0.5
2000,"2000-11-05",46,47,"11/7/2000",2,-1,48.4,47.9,0.5
2000,"2000-11-05",44,47,"11/7/2000",2,-3,48.4,47.9,0.5
2000,"2000-11-05",45,47,"11/7/2000",2,-2,48.4,47.9,0.5
2000,"2000-11-06",45,47,"11/7/2000",1,-2,48.4,47.9,0.5
2000,"2000-11-06",41,46,"11/7/2000",1,-5,48.4,47.9,0.5
2004,"2003-10-18",41,45,"11/2/2004",381,-4,48.3,50.7,-2.40000000000001
2004,"2003-10-24",42,50,"11/2/2004",375,-8,48.3,50.7,-2.40000000000001
2004,"2003-11-07",45,49,"11/2/2004",361,-4,48.3,50.7,-2.40000000000001
2004,"2003-11-16",46,52,"11/2/2004",352,-6,48.3,50.7,-2.40000000000001
2004,"2003-11-16",42,49,"11/2/2004",352,-7,48.3,50.7,-2.40000000000001
2004,"2003-12-12",41,51,"11/2/2004",326,-10,48.3,50.7,-2.40000000000001
2004,"2003-12-16",39,51,"11/2/2004",322,-12,48.3,50.7,-2.40000000000001
2004,"2003-12-16",39,56,"11/2/2004",322,-17,48.3,50.7,-2.40000000000001
2004,"2004-01-01",43,54,"11/2/2004",306,-11,48.3,50.7,-2.40000000000001
2004,"2004-01-04",41,52,"11/2/2004",303,-11,48.3,50.7,-2.40000000000001
2004,"2004-01-08",32,54,"11/2/2004",299,-22,48.3,50.7,-2.40000000000001
2004,"2004-01-09",41,52,"11/2/2004",298,-11,48.3,50.7,-2.40000000000001
2004,"2004-01-11",43,55,"11/2/2004",296,-12,48.3,50.7,-2.40000000000001
2004,"2004-01-12",35,54,"11/2/2004",295,-19,48.3,50.7,-2.40000000000001
2004,"2004-01-16",47,46,"11/2/2004",291,1,48.3,50.7,-2.40000000000001
2004,"2004-01-22",42,49,"11/2/2004",285,-7,48.3,50.7,-2.40000000000001
2004,"2004-01-23",49,46,"11/2/2004",284,3,48.3,50.7,-2.40000000000001
2004,"2004-01-25",45,49,"11/2/2004",282,-4,48.3,50.7,-2.40000000000001
2004,"2004-01-30",48,46,"11/2/2004",277,2,48.3,50.7,-2.40000000000001
2004,"2004-01-31",51,43,"11/2/2004",276,8,48.3,50.7,-2.40000000000001
2004,"2004-02-01",53,46,"11/2/2004",275,7,48.3,50.7,-2.40000000000001
2004,"2004-02-05",43,47,"11/2/2004",271,-4,48.3,50.7,-2.40000000000001
2004,"2004-02-06",50,45,"11/2/2004",270,5,48.3,50.7,-2.40000000000001
2004,"2004-02-06",48,50,"11/2/2004",270,-2,48.3,50.7,-2.40000000000001
2004,"2004-02-08",48,49,"11/2/2004",268,-1,48.3,50.7,-2.40000000000001
2004,"2004-02-11",52,43,"11/2/2004",265,9,48.3,50.7,-2.40000000000001
2004,"2004-02-15",48,43,"11/2/2004",261,5,48.3,50.7,-2.40000000000001
2004,"2004-02-15",51,47,"11/2/2004",261,4,48.3,50.7,-2.40000000000001
2004,"2004-02-16",48,46,"11/2/2004",260,2,48.3,50.7,-2.40000000000001
2004,"2004-02-16",45,47,"11/2/2004",260,-2,48.3,50.7,-2.40000000000001
2004,"2004-02-16",46,45,"11/2/2004",260,1,48.3,50.7,-2.40000000000001
2004,"2004-02-16",47,47,"11/2/2004",260,0,48.3,50.7,-2.40000000000001
2004,"2004-02-17",55,43,"11/2/2004",259,12,48.3,50.7,-2.40000000000001
2004,"2004-02-19",45,45,"11/2/2004",257,0,48.3,50.7,-2.40000000000001
2004,"2004-02-20",48,45,"11/2/2004",256,3,48.3,50.7,-2.40000000000001
2004,"2004-02-27",47,46,"11/2/2004",249,1,48.3,50.7,-2.40000000000001
2004,"2004-02-29",48,44,"11/2/2004",247,4,48.3,50.7,-2.40000000000001
2004,"2004-03-01",47,45,"11/2/2004",246,2,48.3,50.7,-2.40000000000001
2004,"2004-03-03",45,46,"11/2/2004",244,-1,48.3,50.7,-2.40000000000001
2004,"2004-03-04",44,44,"11/2/2004",243,0,48.3,50.7,-2.40000000000001
2004,"2004-03-07",52,44,"11/2/2004",240,8,48.3,50.7,-2.40000000000001
2004,"2004-03-07",53,44,"11/2/2004",240,9,48.3,50.7,-2.40000000000001
2004,"2004-03-07",44,41,"11/2/2004",240,3,48.3,50.7,-2.40000000000001
2004,"2004-03-08",45,48,"11/2/2004",239,-3,48.3,50.7,-2.40000000000001
2004,"2004-03-11",50,43,"11/2/2004",236,7,48.3,50.7,-2.40000000000001
2004,"2004-03-11",43,46,"11/2/2004",236,-3,48.3,50.7,-2.40000000000001
2004,"2004-03-14",43,46,"11/2/2004",233,-3,48.3,50.7,-2.40000000000001
2004,"2004-03-16",45,46,"11/2/2004",231,-1,48.3,50.7,-2.40000000000001
2004,"2004-03-19",48,48,"11/2/2004",228,0,48.3,50.7,-2.40000000000001
2004,"2004-03-19",41,46,"11/2/2004",228,-5,48.3,50.7,-2.40000000000001
2004,"2004-03-19",48,46,"11/2/2004",228,2,48.3,50.7,-2.40000000000001
2004,"2004-03-21",43,46,"11/2/2004",226,-3,48.3,50.7,-2.40000000000001
2004,"2004-03-21",52,43,"11/2/2004",226,9,48.3,50.7,-2.40000000000001
2004,"2004-03-21",47,50,"11/2/2004",226,-3,48.3,50.7,-2.40000000000001
2004,"2004-03-22",43,46,"11/2/2004",225,-3,48.3,50.7,-2.40000000000001
2004,"2004-03-24",44,44,"11/2/2004",223,0,48.3,50.7,-2.40000000000001
2004,"2004-03-26",48,47,"11/2/2004",221,1,48.3,50.7,-2.40000000000001
2004,"2004-03-28",47,51,"11/2/2004",219,-4,48.3,50.7,-2.40000000000001
2004,"2004-03-28",47,46,"11/2/2004",219,1,48.3,50.7,-2.40000000000001
2004,"2004-03-30",49,46,"11/2/2004",217,3,48.3,50.7,-2.40000000000001
2004,"2004-03-31",49,48,"11/2/2004",216,1,48.3,50.7,-2.40000000000001
2004,"2004-04-01",48,43,"11/2/2004",215,5,48.3,50.7,-2.40000000000001
2004,"2004-04-04",47,45,"11/2/2004",212,2,48.3,50.7,-2.40000000000001
2004,"2004-04-07",44,43,"11/2/2004",209,1,48.3,50.7,-2.40000000000001
2004,"2004-04-07",44,45,"11/2/2004",209,-1,48.3,50.7,-2.40000000000001
2004,"2004-04-08",45,48,"11/2/2004",208,-3,48.3,50.7,-2.40000000000001
2004,"2004-04-08",47,49,"11/2/2004",208,-2,48.3,50.7,-2.40000000000001
2004,"2004-04-09",50,43,"11/2/2004",207,7,48.3,50.7,-2.40000000000001
2004,"2004-04-09",50,44,"11/2/2004",207,6,48.3,50.7,-2.40000000000001
2004,"2004-04-14",43,37,"11/2/2004",202,6,48.3,50.7,-2.40000000000001
2004,"2004-04-15",43,46,"11/2/2004",201,-3,48.3,50.7,-2.40000000000001
2004,"2004-04-15",43,43,"11/2/2004",201,0,48.3,50.7,-2.40000000000001
2004,"2004-04-17",47,44,"11/2/2004",199,3,48.3,50.7,-2.40000000000001
2004,"2004-04-18",46,51,"11/2/2004",198,-5,48.3,50.7,-2.40000000000001
2004,"2004-04-18",48,49,"11/2/2004",198,-1,48.3,50.7,-2.40000000000001
2004,"2004-04-22",42,43,"11/2/2004",194,-1,48.3,50.7,-2.40000000000001
2004,"2004-04-22",48,49,"11/2/2004",194,-1,48.3,50.7,-2.40000000000001
2004,"2004-04-23",44,47,"11/2/2004",193,-3,48.3,50.7,-2.40000000000001
2004,"2004-04-27",46,44,"11/2/2004",189,2,48.3,50.7,-2.40000000000001
2004,"2004-05-01",38,42,"11/2/2004",185,-4,48.3,50.7,-2.40000000000001
2004,"2004-05-03",43,44,"11/2/2004",183,-1,48.3,50.7,-2.40000000000001
2004,"2004-05-03",45,48,"11/2/2004",183,-3,48.3,50.7,-2.40000000000001
2004,"2004-05-04",49,48,"11/2/2004",182,1,48.3,50.7,-2.40000000000001
2004,"2004-05-05",41,44,"11/2/2004",181,-3,48.3,50.7,-2.40000000000001
2004,"2004-05-05",43,46,"11/2/2004",181,-3,48.3,50.7,-2.40000000000001
2004,"2004-05-06",47,44,"11/2/2004",180,3,48.3,50.7,-2.40000000000001
2004,"2004-05-06",43,46,"11/2/2004",180,-3,48.3,50.7,-2.40000000000001
2004,"2004-05-09",47,48,"11/2/2004",177,-1,48.3,50.7,-2.40000000000001
2004,"2004-05-09",50,45,"11/2/2004",177,5,48.3,50.7,-2.40000000000001
2004,"2004-05-13",49,47,"11/2/2004",173,2,48.3,50.7,-2.40000000000001
2004,"2004-05-13",47,42,"11/2/2004",173,5,48.3,50.7,-2.40000000000001
2004,"2004-05-13",51,46,"11/2/2004",173,5,48.3,50.7,-2.40000000000001
2004,"2004-05-14",46,45,"11/2/2004",172,1,48.3,50.7,-2.40000000000001
2004,"2004-05-18",43,42,"11/2/2004",168,1,48.3,50.7,-2.40000000000001
2004,"2004-05-19",42,42,"11/2/2004",167,0,48.3,50.7,-2.40000000000001
2004,"2004-05-22",49,44,"11/2/2004",164,5,48.3,50.7,-2.40000000000001
2004,"2004-05-23",49,41,"11/2/2004",163,8,48.3,50.7,-2.40000000000001
2004,"2004-05-23",49,47,"11/2/2004",163,2,48.3,50.7,-2.40000000000001
2004,"2004-05-23",49,47,"11/2/2004",163,2,48.3,50.7,-2.40000000000001
2004,"2004-05-24",45,45,"11/2/2004",162,0,48.3,50.7,-2.40000000000001
2004,"2004-06-03",48,46,"11/2/2004",152,2,48.3,50.7,-2.40000000000001
2004,"2004-06-04",48,49,"11/2/2004",151,-1,48.3,50.7,-2.40000000000001
2004,"2004-06-05",44,42,"11/2/2004",150,2,48.3,50.7,-2.40000000000001
2004,"2004-06-06",44,45,"11/2/2004",149,-1,48.3,50.7,-2.40000000000001
2004,"2004-06-06",50,44,"11/2/2004",149,6,48.3,50.7,-2.40000000000001
2004,"2004-06-08",51,44,"11/2/2004",147,7,48.3,50.7,-2.40000000000001
2004,"2004-06-09",45,43,"11/2/2004",146,2,48.3,50.7,-2.40000000000001
2004,"2004-06-09",47,44,"11/2/2004",146,3,48.3,50.7,-2.40000000000001
2004,"2004-06-10",48,49,"11/2/2004",145,-1,48.3,50.7,-2.40000000000001
2004,"2004-06-13",43,44,"11/2/2004",142,-1,48.3,50.7,-2.40000000000001
2004,"2004-06-13",46,48,"11/2/2004",142,-2,48.3,50.7,-2.40000000000001
2004,"2004-06-15",41,51,"11/2/2004",140,-10,48.3,50.7,-2.40000000000001
2004,"2004-06-15",42,48,"11/2/2004",140,-6,48.3,50.7,-2.40000000000001
2004,"2004-06-17",49,48,"11/2/2004",138,1,48.3,50.7,-2.40000000000001
2004,"2004-06-19",44,44,"11/2/2004",136,0,48.3,50.7,-2.40000000000001
2004,"2004-06-20",53,45,"11/2/2004",135,8,48.3,50.7,-2.40000000000001
2004,"2004-06-23",48,48,"11/2/2004",132,0,48.3,50.7,-2.40000000000001
2004,"2004-06-23",42,48,"11/2/2004",132,-6,48.3,50.7,-2.40000000000001
2004,"2004-06-23",48,49,"11/2/2004",132,-1,48.3,50.7,-2.40000000000001
2004,"2004-06-27",45,44,"11/2/2004",128,1,48.3,50.7,-2.40000000000001
2004,"2004-06-28",47,47,"11/2/2004",127,0,48.3,50.7,-2.40000000000001
2004,"2004-07-03",49,45,"11/2/2004",122,4,48.3,50.7,-2.40000000000001
2004,"2004-07-06",54,43,"11/2/2004",119,11,48.3,50.7,-2.40000000000001
2004,"2004-07-07",47,45,"11/2/2004",118,2,48.3,50.7,-2.40000000000001
2004,"2004-07-07",46,50,"11/2/2004",118,-4,48.3,50.7,-2.40000000000001
2004,"2004-07-07",46,44,"11/2/2004",118,2,48.3,50.7,-2.40000000000001
2004,"2004-07-08",49,45,"11/2/2004",117,4,48.3,50.7,-2.40000000000001
2004,"2004-07-09",51,45,"11/2/2004",116,6,48.3,50.7,-2.40000000000001
2004,"2004-07-10",49,44,"11/2/2004",115,5,48.3,50.7,-2.40000000000001
2004,"2004-07-10",49,44,"11/2/2004",115,5,48.3,50.7,-2.40000000000001
2004,"2004-07-11",50,46,"11/2/2004",114,4,48.3,50.7,-2.40000000000001
2004,"2004-07-11",51,44,"11/2/2004",114,7,48.3,50.7,-2.40000000000001
2004,"2004-07-11",46,46,"11/2/2004",114,0,48.3,50.7,-2.40000000000001
2004,"2004-07-13",52,45,"11/2/2004",112,7,48.3,50.7,-2.40000000000001
2004,"2004-07-15",49,44,"11/2/2004",110,5,48.3,50.7,-2.40000000000001
2004,"2004-07-15",47,46,"11/2/2004",110,1,48.3,50.7,-2.40000000000001
2004,"2004-07-15",47,46,"11/2/2004",110,1,48.3,50.7,-2.40000000000001
2004,"2004-07-15",45,46,"11/2/2004",110,-1,48.3,50.7,-2.40000000000001
2004,"2004-07-17",44,41,"11/2/2004",108,3,48.3,50.7,-2.40000000000001
2004,"2004-07-18",46,44,"11/2/2004",107,2,48.3,50.7,-2.40000000000001
2004,"2004-07-21",45,44,"11/2/2004",104,1,48.3,50.7,-2.40000000000001
2004,"2004-07-21",44,44,"11/2/2004",104,0,48.3,50.7,-2.40000000000001
2004,"2004-07-21",49,47,"11/2/2004",104,2,48.3,50.7,-2.40000000000001
2004,"2004-07-21",49,45,"11/2/2004",104,4,48.3,50.7,-2.40000000000001
2004,"2004-07-21",45,47,"11/2/2004",104,-2,48.3,50.7,-2.40000000000001
2004,"2004-07-21",48,46,"11/2/2004",104,2,48.3,50.7,-2.40000000000001
2004,"2004-07-22",50,46,"11/2/2004",103,4,48.3,50.7,-2.40000000000001
2004,"2004-07-22",50,45,"11/2/2004",103,5,48.3,50.7,-2.40000000000001
2004,"2004-07-22",46,43,"11/2/2004",103,3,48.3,50.7,-2.40000000000001
2004,"2004-07-24",46,43,"11/2/2004",101,3,48.3,50.7,-2.40000000000001
2004,"2004-07-25",47,51,"11/2/2004",100,-4,48.3,50.7,-2.40000000000001
2004,"2004-07-25",48,49,"11/2/2004",100,-1,48.3,50.7,-2.40000000000001
2004,"2004-07-29",46,41,"11/2/2004",96,5,48.3,50.7,-2.40000000000001
2004,"2004-07-29",48,43,"11/2/2004",96,5,48.3,50.7,-2.40000000000001
2004,"2004-07-30",52,44,"11/2/2004",95,8,48.3,50.7,-2.40000000000001
2004,"2004-07-31",47,50,"11/2/2004",94,-3,48.3,50.7,-2.40000000000001
2004,"2004-07-31",50,47,"11/2/2004",94,3,48.3,50.7,-2.40000000000001
2004,"2004-08-01",49,43,"11/2/2004",93,6,48.3,50.7,-2.40000000000001
2004,"2004-08-01",47,51,"11/2/2004",93,-4,48.3,50.7,-2.40000000000001
2004,"2004-08-01",48,48,"11/2/2004",93,0,48.3,50.7,-2.40000000000001
2004,"2004-08-01",49,48,"11/2/2004",93,1,48.3,50.7,-2.40000000000001
2004,"2004-08-01",52,45,"11/2/2004",93,7,48.3,50.7,-2.40000000000001
2004,"2004-08-01",49,46,"11/2/2004",93,3,48.3,50.7,-2.40000000000001
2004,"2004-08-02",47,47,"11/2/2004",92,0,48.3,50.7,-2.40000000000001
2004,"2004-08-02",47,46,"11/2/2004",92,1,48.3,50.7,-2.40000000000001
2004,"2004-08-04",48,43,"11/2/2004",90,5,48.3,50.7,-2.40000000000001
2004,"2004-08-04",46,43,"11/2/2004",90,3,48.3,50.7,-2.40000000000001
2004,"2004-08-05",49,43,"11/2/2004",89,6,48.3,50.7,-2.40000000000001
2004,"2004-08-05",52,45,"11/2/2004",89,7,48.3,50.7,-2.40000000000001
2004,"2004-08-05",51,44,"11/2/2004",89,7,48.3,50.7,-2.40000000000001
2004,"2004-08-05",51,43,"11/2/2004",89,8,48.3,50.7,-2.40000000000001
2004,"2004-08-05",48,45,"11/2/2004",89,3,48.3,50.7,-2.40000000000001
2004,"2004-08-08",48,48,"11/2/2004",86,0,48.3,50.7,-2.40000000000001
2004,"2004-08-08",50,45,"11/2/2004",86,5,48.3,50.7,-2.40000000000001
2004,"2004-08-10",47,45,"11/2/2004",84,2,48.3,50.7,-2.40000000000001
2004,"2004-08-11",47,50,"11/2/2004",83,-3,48.3,50.7,-2.40000000000001
2004,"2004-08-11",47,48,"11/2/2004",83,-1,48.3,50.7,-2.40000000000001
2004,"2004-08-14",47,43,"11/2/2004",80,4,48.3,50.7,-2.40000000000001
2004,"2004-08-14",50,43,"11/2/2004",80,7,48.3,50.7,-2.40000000000001
2004,"2004-08-15",47,47,"11/2/2004",79,0,48.3,50.7,-2.40000000000001
2004,"2004-08-17",49,47,"11/2/2004",77,2,48.3,50.7,-2.40000000000001
2004,"2004-08-18",47,44,"11/2/2004",76,3,48.3,50.7,-2.40000000000001
2004,"2004-08-23",44,44,"11/2/2004",71,0,48.3,50.7,-2.40000000000001
2004,"2004-08-24",46,49,"11/2/2004",70,-3,48.3,50.7,-2.40000000000001
2004,"2004-08-24",50,45,"11/2/2004",70,5,48.3,50.7,-2.40000000000001
2004,"2004-08-25",45,44,"11/2/2004",69,1,48.3,50.7,-2.40000000000001
2004,"2004-08-25",47,50,"11/2/2004",69,-3,48.3,50.7,-2.40000000000001
2004,"2004-08-25",48,47,"11/2/2004",69,1,48.3,50.7,-2.40000000000001
2004,"2004-08-25",45,47,"11/2/2004",69,-2,48.3,50.7,-2.40000000000001
2004,"2004-08-26",48,48,"11/2/2004",68,0,48.3,50.7,-2.40000000000001
2004,"2004-08-29",49,49,"11/2/2004",65,0,48.3,50.7,-2.40000000000001
2004,"2004-08-29",49,48,"11/2/2004",65,1,48.3,50.7,-2.40000000000001
2004,"2004-08-29",50,46,"11/2/2004",65,4,48.3,50.7,-2.40000000000001
2004,"2004-08-29",51,44,"11/2/2004",65,7,48.3,50.7,-2.40000000000001
2004,"2004-08-29",45,45,"11/2/2004",65,0,48.3,50.7,-2.40000000000001
2004,"2004-09-01",47,48,"11/2/2004",62,-1,48.3,50.7,-2.40000000000001
2004,"2004-09-01",48,46,"11/2/2004",62,2,48.3,50.7,-2.40000000000001
2004,"2004-09-02",43,46,"11/2/2004",61,-3,48.3,50.7,-2.40000000000001
2004,"2004-09-02",43,53,"11/2/2004",61,-10,48.3,50.7,-2.40000000000001
2004,"2004-09-02",42,50,"11/2/2004",61,-8,48.3,50.7,-2.40000000000001
2004,"2004-09-02",44,46,"11/2/2004",61,-2,48.3,50.7,-2.40000000000001
2004,"2004-09-03",43,54,"11/2/2004",60,-11,48.3,50.7,-2.40000000000001
2004,"2004-09-05",45,52,"11/2/2004",58,-7,48.3,50.7,-2.40000000000001
2004,"2004-09-05",48,49,"11/2/2004",58,-1,48.3,50.7,-2.40000000000001
2004,"2004-09-05",47,48,"11/2/2004",58,-1,48.3,50.7,-2.40000000000001
2004,"2004-09-05",47,46,"11/2/2004",58,1,48.3,50.7,-2.40000000000001
2004,"2004-09-08",42,50,"11/2/2004",55,-8,48.3,50.7,-2.40000000000001
2004,"2004-09-08",45,47,"11/2/2004",55,-2,48.3,50.7,-2.40000000000001
2004,"2004-09-08",43,52,"11/2/2004",55,-9,48.3,50.7,-2.40000000000001
2004,"2004-09-08",44,50,"11/2/2004",55,-6,48.3,50.7,-2.40000000000001
2004,"2004-09-09",42,46,"11/2/2004",54,-4,48.3,50.7,-2.40000000000001
2004,"2004-09-09",47,50,"11/2/2004",54,-3,48.3,50.7,-2.40000000000001
2004,"2004-09-09",42,54,"11/2/2004",54,-12,48.3,50.7,-2.40000000000001
2004,"2004-09-09",39,51,"11/2/2004",54,-12,48.3,50.7,-2.40000000000001
2004,"2004-09-09",46,51,"11/2/2004",54,-5,48.3,50.7,-2.40000000000001
2004,"2004-09-09",43,51,"11/2/2004",54,-8,48.3,50.7,-2.40000000000001
2004,"2004-09-09",45,47,"11/2/2004",54,-2,48.3,50.7,-2.40000000000001
2004,"2004-09-10",38,54,"11/2/2004",53,-16,48.3,50.7,-2.40000000000001
2004,"2004-09-10",40,52,"11/2/2004",53,-12,48.3,50.7,-2.40000000000001
2004,"2004-09-10",45,50,"11/2/2004",53,-5,48.3,50.7,-2.40000000000001
2004,"2004-09-12",47,47,"11/2/2004",51,0,48.3,50.7,-2.40000000000001
2004,"2004-09-12",46,44,"11/2/2004",51,2,48.3,50.7,-2.40000000000001
2004,"2004-09-12",44,52,"11/2/2004",51,-8,48.3,50.7,-2.40000000000001
2004,"2004-09-12",45,49,"11/2/2004",51,-4,48.3,50.7,-2.40000000000001
2004,"2004-09-12",45,49,"11/2/2004",51,-4,48.3,50.7,-2.40000000000001
2004,"2004-09-13",48,47,"11/2/2004",50,1,48.3,50.7,-2.40000000000001
2004,"2004-09-14",48,49,"11/2/2004",49,-1,48.3,50.7,-2.40000000000001
2004,"2004-09-14",46,47,"11/2/2004",49,-1,48.3,50.7,-2.40000000000001
2004,"2004-09-14",46,46,"11/2/2004",49,0,48.3,50.7,-2.40000000000001
2004,"2004-09-15",42,55,"11/2/2004",48,-13,48.3,50.7,-2.40000000000001
2004,"2004-09-15",44,52,"11/2/2004",48,-8,48.3,50.7,-2.40000000000001
2004,"2004-09-15",40,54,"11/2/2004",48,-14,48.3,50.7,-2.40000000000001
2004,"2004-09-15",42,50,"11/2/2004",48,-8,48.3,50.7,-2.40000000000001
2004,"2004-09-16",45,49,"11/2/2004",47,-4,48.3,50.7,-2.40000000000001
2004,"2004-09-16",42,50,"11/2/2004",47,-8,48.3,50.7,-2.40000000000001
2004,"2004-09-18",43,46,"11/2/2004",45,-3,48.3,50.7,-2.40000000000001
2004,"2004-09-18",43,44,"11/2/2004",45,-1,48.3,50.7,-2.40000000000001
2004,"2004-09-19",43,46,"11/2/2004",44,-3,48.3,50.7,-2.40000000000001
2004,"2004-09-19",46,49,"11/2/2004",44,-3,48.3,50.7,-2.40000000000001
2004,"2004-09-19",46,49,"11/2/2004",44,-3,48.3,50.7,-2.40000000000001
2004,"2004-09-19",44,47,"11/2/2004",44,-3,48.3,50.7,-2.40000000000001
2004,"2004-09-21",49,49,"11/2/2004",42,0,48.3,50.7,-2.40000000000001
2004,"2004-09-21",42,45,"11/2/2004",42,-3,48.3,50.7,-2.40000000000001
2004,"2004-09-22",41,49,"11/2/2004",41,-8,48.3,50.7,-2.40000000000001
2004,"2004-09-22",43,45,"11/2/2004",41,-2,48.3,50.7,-2.40000000000001
2004,"2004-09-22",45,52,"11/2/2004",41,-7,48.3,50.7,-2.40000000000001
2004,"2004-09-22",42,51,"11/2/2004",41,-9,48.3,50.7,-2.40000000000001
2004,"2004-09-22",44,50,"11/2/2004",41,-6,48.3,50.7,-2.40000000000001
2004,"2004-09-22",45,48,"11/2/2004",41,-3,48.3,50.7,-2.40000000000001
2004,"2004-09-23",45,50,"11/2/2004",40,-5,48.3,50.7,-2.40000000000001
2004,"2004-09-23",45,49,"11/2/2004",40,-4,48.3,50.7,-2.40000000000001
2004,"2004-09-23",44,48,"11/2/2004",40,-4,48.3,50.7,-2.40000000000001
2004,"2004-09-26",44,52,"11/2/2004",37,-8,48.3,50.7,-2.40000000000001
2004,"2004-09-26",41,54,"11/2/2004",37,-13,48.3,50.7,-2.40000000000001
2004,"2004-09-26",45,51,"11/2/2004",37,-6,48.3,50.7,-2.40000000000001
2004,"2004-09-26",44,51,"11/2/2004",37,-7,48.3,50.7,-2.40000000000001
2004,"2004-09-26",40,48,"11/2/2004",37,-8,48.3,50.7,-2.40000000000001
2004,"2004-09-27",46,45,"11/2/2004",36,1,48.3,50.7,-2.40000000000001
2004,"2004-09-27",44,44,"11/2/2004",36,0,48.3,50.7,-2.40000000000001
2004,"2004-09-28",46,49,"11/2/2004",35,-3,48.3,50.7,-2.40000000000001
2004,"2004-09-28",43,51,"11/2/2004",35,-8,48.3,50.7,-2.40000000000001
2004,"2004-09-28",43,50,"11/2/2004",35,-7,48.3,50.7,-2.40000000000001
2004,"2004-09-28",46,51,"11/2/2004",35,-5,48.3,50.7,-2.40000000000001
2004,"2004-09-28",45,49,"11/2/2004",35,-4,48.3,50.7,-2.40000000000001
2004,"2004-09-30",44,51,"11/2/2004",33,-7,48.3,50.7,-2.40000000000001
2004,"2004-10-02",49,46,"11/2/2004",31,3,48.3,50.7,-2.40000000000001
2004,"2004-10-03",43,46,"11/2/2004",30,-3,48.3,50.7,-2.40000000000001
2004,"2004-10-03",47,48,"11/2/2004",30,-1,48.3,50.7,-2.40000000000001
2004,"2004-10-03",49,49,"11/2/2004",30,0,48.3,50.7,-2.40000000000001
2004,"2004-10-03",48,49,"11/2/2004",30,-1,48.3,50.7,-2.40000000000001
2004,"2004-10-03",46,51,"11/2/2004",30,-5,48.3,50.7,-2.40000000000001
2004,"2004-10-03",46,51,"11/2/2004",30,-5,48.3,50.7,-2.40000000000001
2004,"2004-10-03",46,49,"11/2/2004",30,-3,48.3,50.7,-2.40000000000001
2004,"2004-10-03",45,50,"11/2/2004",30,-5,48.3,50.7,-2.40000000000001
2004,"2004-10-03",44,49,"11/2/2004",30,-5,48.3,50.7,-2.40000000000001
2004,"2004-10-03",41,48,"11/2/2004",30,-7,48.3,50.7,-2.40000000000001
2004,"2004-10-03",45,48,"11/2/2004",30,-3,48.3,50.7,-2.40000000000001
2004,"2004-10-03",45,46,"11/2/2004",30,-1,48.3,50.7,-2.40000000000001
2004,"2004-10-04",45,48,"11/2/2004",29,-3,48.3,50.7,-2.40000000000001
2004,"2004-10-04",45,51,"11/2/2004",29,-6,48.3,50.7,-2.40000000000001
2004,"2004-10-04",45,51,"11/2/2004",29,-6,48.3,50.7,-2.40000000000001
2004,"2004-10-04",44,50,"11/2/2004",29,-6,48.3,50.7,-2.40000000000001
2004,"2004-10-04",43,52,"11/2/2004",29,-9,48.3,50.7,-2.40000000000001
2004,"2004-10-04",47,46,"11/2/2004",29,1,48.3,50.7,-2.40000000000001
2004,"2004-10-04",48,45,"11/2/2004",29,3,48.3,50.7,-2.40000000000001
2004,"2004-10-05",49,48,"11/2/2004",28,1,48.3,50.7,-2.40000000000001
2004,"2004-10-05",47,49,"11/2/2004",28,-2,48.3,50.7,-2.40000000000001
2004,"2004-10-05",47,49,"11/2/2004",28,-2,48.3,50.7,-2.40000000000001
2004,"2004-10-05",46,49,"11/2/2004",28,-3,48.3,50.7,-2.40000000000001
2004,"2004-10-05",45,50,"11/2/2004",28,-5,48.3,50.7,-2.40000000000001
2004,"2004-10-05",46,51,"11/2/2004",28,-5,48.3,50.7,-2.40000000000001
2004,"2004-10-05",46,50,"11/2/2004",28,-4,48.3,50.7,-2.40000000000001
2004,"2004-10-05",46,49,"11/2/2004",28,-3,48.3,50.7,-2.40000000000001
2004,"2004-10-05",46,47,"11/2/2004",28,-1,48.3,50.7,-2.40000000000001
2004,"2004-10-06",44,46,"11/2/2004",27,-2,48.3,50.7,-2.40000000000001
2004,"2004-10-06",47,49,"11/2/2004",27,-2,48.3,50.7,-2.40000000000001
2004,"2004-10-06",47,49,"11/2/2004",27,-2,48.3,50.7,-2.40000000000001
2004,"2004-10-06",47,48,"11/2/2004",27,-1,48.3,50.7,-2.40000000000001
2004,"2004-10-06",46,49,"11/2/2004",27,-3,48.3,50.7,-2.40000000000001
2004,"2004-10-06",50,46,"11/2/2004",27,4,48.3,50.7,-2.40000000000001
2004,"2004-10-06",47,47,"11/2/2004",27,0,48.3,50.7,-2.40000000000001
2004,"2004-10-07",45,46,"11/2/2004",26,-1,48.3,50.7,-2.40000000000001
2004,"2004-10-07",46,49,"11/2/2004",26,-3,48.3,50.7,-2.40000000000001
2004,"2004-10-07",47,50,"11/2/2004",26,-3,48.3,50.7,-2.40000000000001
2004,"2004-10-07",47,50,"11/2/2004",26,-3,48.3,50.7,-2.40000000000001
2004,"2004-10-07",47,48,"11/2/2004",26,-1,48.3,50.7,-2.40000000000001
2004,"2004-10-07",47,48,"11/2/2004",26,-1,48.3,50.7,-2.40000000000001
2004,"2004-10-07",46,47,"11/2/2004",26,-1,48.3,50.7,-2.40000000000001
2004,"2004-10-07",44,43,"11/2/2004",26,1,48.3,50.7,-2.40000000000001
2004,"2004-10-08",46,45,"11/2/2004",25,1,48.3,50.7,-2.40000000000001
2004,"2004-10-08",46,50,"11/2/2004",25,-4,48.3,50.7,-2.40000000000001
2004,"2004-10-08",47,50,"11/2/2004",25,-3,48.3,50.7,-2.40000000000001
2004,"2004-10-08",46,48,"11/2/2004",25,-2,48.3,50.7,-2.40000000000001
2004,"2004-10-08",46,48,"11/2/2004",25,-2,48.3,50.7,-2.40000000000001
2004,"2004-10-09",46,45,"11/2/2004",24,1,48.3,50.7,-2.40000000000001
2004,"2004-10-09",46,51,"11/2/2004",24,-5,48.3,50.7,-2.40000000000001
2004,"2004-10-09",46,50,"11/2/2004",24,-4,48.3,50.7,-2.40000000000001
2004,"2004-10-09",47,48,"11/2/2004",24,-1,48.3,50.7,-2.40000000000001
2004,"2004-10-09",47,48,"11/2/2004",24,-1,48.3,50.7,-2.40000000000001
2004,"2004-10-10",47,44,"11/2/2004",23,3,48.3,50.7,-2.40000000000001
2004,"2004-10-10",50,48,"11/2/2004",23,2,48.3,50.7,-2.40000000000001
2004,"2004-10-10",48,48,"11/2/2004",23,0,48.3,50.7,-2.40000000000001
2004,"2004-10-10",45,51,"11/2/2004",23,-6,48.3,50.7,-2.40000000000001
2004,"2004-10-10",46,50,"11/2/2004",23,-4,48.3,50.7,-2.40000000000001
2004,"2004-10-10",47,47,"11/2/2004",23,0,48.3,50.7,-2.40000000000001
2004,"2004-10-10",46,48,"11/2/2004",23,-2,48.3,50.7,-2.40000000000001
2004,"2004-10-11",45,45,"11/2/2004",22,0,48.3,50.7,-2.40000000000001
2004,"2004-10-11",44,45,"11/2/2004",22,-1,48.3,50.7,-2.40000000000001
2004,"2004-10-11",46,47,"11/2/2004",22,-1,48.3,50.7,-2.40000000000001
2004,"2004-10-11",48,48,"11/2/2004",22,0,48.3,50.7,-2.40000000000001
2004,"2004-10-11",47,50,"11/2/2004",22,-3,48.3,50.7,-2.40000000000001
2004,"2004-10-11",46,50,"11/2/2004",22,-4,48.3,50.7,-2.40000000000001
2004,"2004-10-11",48,46,"11/2/2004",22,2,48.3,50.7,-2.40000000000001
2004,"2004-10-11",46,48,"11/2/2004",22,-2,48.3,50.7,-2.40000000000001
2004,"2004-10-11",46,49,"11/2/2004",22,-3,48.3,50.7,-2.40000000000001
2004,"2004-10-11",46,48,"11/2/2004",22,-2,48.3,50.7,-2.40000000000001
2004,"2004-10-12",45,45,"11/2/2004",21,0,48.3,50.7,-2.40000000000001
2004,"2004-10-12",43,46,"11/2/2004",21,-3,48.3,50.7,-2.40000000000001
2004,"2004-10-12",49,48,"11/2/2004",21,1,48.3,50.7,-2.40000000000001
2004,"2004-10-12",48,48,"11/2/2004",21,0,48.3,50.7,-2.40000000000001
2004,"2004-10-12",48,46,"11/2/2004",21,2,48.3,50.7,-2.40000000000001
2004,"2004-10-12",47,47,"11/2/2004",21,0,48.3,50.7,-2.40000000000001
2004,"2004-10-13",45,46,"11/2/2004",20,-1,48.3,50.7,-2.40000000000001
2004,"2004-10-13",42,46,"11/2/2004",20,-4,48.3,50.7,-2.40000000000001
2004,"2004-10-13",48,48,"11/2/2004",20,0,48.3,50.7,-2.40000000000001
2004,"2004-10-13",48,48,"11/2/2004",20,0,48.3,50.7,-2.40000000000001
2004,"2004-10-13",47,47,"11/2/2004",20,0,48.3,50.7,-2.40000000000001
2004,"2004-10-13",47,47,"11/2/2004",20,0,48.3,50.7,-2.40000000000001
2004,"2004-10-13",47,48,"11/2/2004",20,-1,48.3,50.7,-2.40000000000001
2004,"2004-10-13",50,45,"11/2/2004",20,5,48.3,50.7,-2.40000000000001
2004,"2004-10-14",44,48,"11/2/2004",19,-4,48.3,50.7,-2.40000000000001
2004,"2004-10-14",46,49,"11/2/2004",19,-3,48.3,50.7,-2.40000000000001
2004,"2004-10-14",43,47,"11/2/2004",19,-4,48.3,50.7,-2.40000000000001
2004,"2004-10-14",48,48,"11/2/2004",19,0,48.3,50.7,-2.40000000000001
2004,"2004-10-14",48,48,"11/2/2004",19,0,48.3,50.7,-2.40000000000001
2004,"2004-10-14",48,47,"11/2/2004",19,1,48.3,50.7,-2.40000000000001
2004,"2004-10-14",48,47,"11/2/2004",19,1,48.3,50.7,-2.40000000000001
2004,"2004-10-15",44,48,"11/2/2004",18,-4,48.3,50.7,-2.40000000000001
2004,"2004-10-15",44,47,"11/2/2004",18,-3,48.3,50.7,-2.40000000000001
2004,"2004-10-15",47,50,"11/2/2004",18,-3,48.3,50.7,-2.40000000000001
2004,"2004-10-15",47,48,"11/2/2004",18,-1,48.3,50.7,-2.40000000000001
2004,"2004-10-15",45,50,"11/2/2004",18,-5,48.3,50.7,-2.40000000000001
2004,"2004-10-15",47,48,"11/2/2004",18,-1,48.3,50.7,-2.40000000000001
2004,"2004-10-15",48,48,"11/2/2004",18,0,48.3,50.7,-2.40000000000001
2004,"2004-10-15",46,46,"11/2/2004",18,0,48.3,50.7,-2.40000000000001
2004,"2004-10-16",44,46,"11/2/2004",17,-2,48.3,50.7,-2.40000000000001
2004,"2004-10-16",43,47,"11/2/2004",17,-4,48.3,50.7,-2.40000000000001
2004,"2004-10-16",50,47,"11/2/2004",17,3,48.3,50.7,-2.40000000000001
2004,"2004-10-16",44,52,"11/2/2004",17,-8,48.3,50.7,-2.40000000000001
2004,"2004-10-16",46,50,"11/2/2004",17,-4,48.3,50.7,-2.40000000000001
2004,"2004-10-16",46,50,"11/2/2004",17,-4,48.3,50.7,-2.40000000000001
2004,"2004-10-16",46,50,"11/2/2004",17,-4,48.3,50.7,-2.40000000000001
2004,"2004-10-16",47,48,"11/2/2004",17,-1,48.3,50.7,-2.40000000000001
2004,"2004-10-16",45,49,"11/2/2004",17,-4,48.3,50.7,-2.40000000000001
2004,"2004-10-17",45,45,"11/2/2004",16,0,48.3,50.7,-2.40000000000001
2004,"2004-10-17",44,47,"11/2/2004",16,-3,48.3,50.7,-2.40000000000001
2004,"2004-10-17",46,47,"11/2/2004",16,-1,48.3,50.7,-2.40000000000001
2004,"2004-10-17",47,50,"11/2/2004",16,-3,48.3,50.7,-2.40000000000001
2004,"2004-10-17",47,50,"11/2/2004",16,-3,48.3,50.7,-2.40000000000001
2004,"2004-10-17",47,48,"11/2/2004",16,-1,48.3,50.7,-2.40000000000001
2004,"2004-10-17",46,49,"11/2/2004",16,-3,48.3,50.7,-2.40000000000001
2004,"2004-10-18",45,45,"11/2/2004",15,0,48.3,50.7,-2.40000000000001
2004,"2004-10-18",45,45,"11/2/2004",15,0,48.3,50.7,-2.40000000000001
2004,"2004-10-18",43,48,"11/2/2004",15,-5,48.3,50.7,-2.40000000000001
2004,"2004-10-18",50,47,"11/2/2004",15,3,48.3,50.7,-2.40000000000001
2004,"2004-10-18",48,48,"11/2/2004",15,0,48.3,50.7,-2.40000000000001
2004,"2004-10-18",46,48,"11/2/2004",15,-2,48.3,50.7,-2.40000000000001
2004,"2004-10-18",46,51,"11/2/2004",15,-5,48.3,50.7,-2.40000000000001
2004,"2004-10-18",46,51,"11/2/2004",15,-5,48.3,50.7,-2.40000000000001
2004,"2004-10-18",45,50,"11/2/2004",15,-5,48.3,50.7,-2.40000000000001
2004,"2004-10-18",44,51,"11/2/2004",15,-7,48.3,50.7,-2.40000000000001
2004,"2004-10-19",46,46,"11/2/2004",14,0,48.3,50.7,-2.40000000000001
2004,"2004-10-19",45,45,"11/2/2004",14,0,48.3,50.7,-2.40000000000001
2004,"2004-10-19",47,50,"11/2/2004",14,-3,48.3,50.7,-2.40000000000001
2004,"2004-10-19",46,51,"11/2/2004",14,-5,48.3,50.7,-2.40000000000001
2004,"2004-10-19",45,51,"11/2/2004",14,-6,48.3,50.7,-2.40000000000001
2004,"2004-10-19",44,51,"11/2/2004",14,-7,48.3,50.7,-2.40000000000001
2004,"2004-10-19",47,47,"11/2/2004",14,0,48.3,50.7,-2.40000000000001
2004,"2004-10-19",45,45,"11/2/2004",14,0,48.3,50.7,-2.40000000000001
2004,"2004-10-19",48,49,"11/2/2004",14,-1,48.3,50.7,-2.40000000000001
2004,"2004-10-19",47,47,"11/2/2004",14,0,48.3,50.7,-2.40000000000001
2004,"2004-10-20",45,46,"11/2/2004",13,-1,48.3,50.7,-2.40000000000001
2004,"2004-10-20",44,45,"11/2/2004",13,-1,48.3,50.7,-2.40000000000001
2004,"2004-10-20",45,51,"11/2/2004",13,-6,48.3,50.7,-2.40000000000001
2004,"2004-10-20",46,51,"11/2/2004",13,-5,48.3,50.7,-2.40000000000001
2004,"2004-10-20",44,51,"11/2/2004",13,-7,48.3,50.7,-2.40000000000001
2004,"2004-10-20",44,51,"11/2/2004",13,-7,48.3,50.7,-2.40000000000001
2004,"2004-10-20",49,46,"11/2/2004",13,3,48.3,50.7,-2.40000000000001
2004,"2004-10-20",47,46,"11/2/2004",13,1,48.3,50.7,-2.40000000000001
2004,"2004-10-21",45,47,"11/2/2004",12,-2,48.3,50.7,-2.40000000000001
2004,"2004-10-21",45,49,"11/2/2004",12,-4,48.3,50.7,-2.40000000000001
2004,"2004-10-21",45,45,"11/2/2004",12,0,48.3,50.7,-2.40000000000001
2004,"2004-10-21",49,47,"11/2/2004",12,2,48.3,50.7,-2.40000000000001
2004,"2004-10-21",46,50,"11/2/2004",12,-4,48.3,50.7,-2.40000000000001
2004,"2004-10-21",46,50,"11/2/2004",12,-4,48.3,50.7,-2.40000000000001
2004,"2004-10-21",44,50,"11/2/2004",12,-6,48.3,50.7,-2.40000000000001
2004,"2004-10-21",44,50,"11/2/2004",12,-6,48.3,50.7,-2.40000000000001
2004,"2004-10-21",46,51,"11/2/2004",12,-5,48.3,50.7,-2.40000000000001
2004,"2004-10-21",43,50,"11/2/2004",12,-7,48.3,50.7,-2.40000000000001
2004,"2004-10-22",45,47,"11/2/2004",11,-2,48.3,50.7,-2.40000000000001
2004,"2004-10-22",44,47,"11/2/2004",11,-3,48.3,50.7,-2.40000000000001
2004,"2004-10-22",46,50,"11/2/2004",11,-4,48.3,50.7,-2.40000000000001
2004,"2004-10-22",45,50,"11/2/2004",11,-5,48.3,50.7,-2.40000000000001
2004,"2004-10-22",47,48,"11/2/2004",11,-1,48.3,50.7,-2.40000000000001
2004,"2004-10-22",47,47,"11/2/2004",11,0,48.3,50.7,-2.40000000000001
2004,"2004-10-23",46,48,"11/2/2004",10,-2,48.3,50.7,-2.40000000000001
2004,"2004-10-23",43,47,"11/2/2004",10,-4,48.3,50.7,-2.40000000000001
2004,"2004-10-23",48,49,"11/2/2004",10,-1,48.3,50.7,-2.40000000000001
2004,"2004-10-23",48,49,"11/2/2004",10,-1,48.3,50.7,-2.40000000000001
2004,"2004-10-23",46,49,"11/2/2004",10,-3,48.3,50.7,-2.40000000000001
2004,"2004-10-23",45,49,"11/2/2004",10,-4,48.3,50.7,-2.40000000000001
2004,"2004-10-24",45,48,"11/2/2004",9,-3,48.3,50.7,-2.40000000000001
2004,"2004-10-24",41,48,"11/2/2004",9,-7,48.3,50.7,-2.40000000000001
2004,"2004-10-24",46,48,"11/2/2004",9,-2,48.3,50.7,-2.40000000000001
2004,"2004-10-24",46,52,"11/2/2004",9,-6,48.3,50.7,-2.40000000000001
2004,"2004-10-24",48,49,"11/2/2004",9,-1,48.3,50.7,-2.40000000000001
2004,"2004-10-24",49,48,"11/2/2004",9,1,48.3,50.7,-2.40000000000001
2004,"2004-10-24",49,48,"11/2/2004",9,1,48.3,50.7,-2.40000000000001
2004,"2004-10-24",48,46,"11/2/2004",9,2,48.3,50.7,-2.40000000000001
2004,"2004-10-24",47,47,"11/2/2004",9,0,48.3,50.7,-2.40000000000001
2004,"2004-10-24",48,49,"11/2/2004",9,-1,48.3,50.7,-2.40000000000001
2004,"2004-10-24",48,47,"11/2/2004",9,1,48.3,50.7,-2.40000000000001
2004,"2004-10-25",46,49,"11/2/2004",8,-3,48.3,50.7,-2.40000000000001
2004,"2004-10-25",42,47,"11/2/2004",8,-5,48.3,50.7,-2.40000000000001
2004,"2004-10-25",49,47,"11/2/2004",8,2,48.3,50.7,-2.40000000000001
2004,"2004-10-25",50,48,"11/2/2004",8,2,48.3,50.7,-2.40000000000001
2004,"2004-10-25",49,48,"11/2/2004",8,1,48.3,50.7,-2.40000000000001
2004,"2004-10-25",48,47,"11/2/2004",8,1,48.3,50.7,-2.40000000000001
2004,"2004-10-25",47,47,"11/2/2004",8,0,48.3,50.7,-2.40000000000001
2004,"2004-10-26",47,48,"11/2/2004",7,-1,48.3,50.7,-2.40000000000001
2004,"2004-10-26",43,47,"11/2/2004",7,-4,48.3,50.7,-2.40000000000001
2004,"2004-10-26",49,48,"11/2/2004",7,1,48.3,50.7,-2.40000000000001
2004,"2004-10-26",49,48,"11/2/2004",7,1,48.3,50.7,-2.40000000000001
2004,"2004-10-26",48,47,"11/2/2004",7,1,48.3,50.7,-2.40000000000001
2004,"2004-10-26",47,47,"11/2/2004",7,0,48.3,50.7,-2.40000000000001
2004,"2004-10-26",48,49,"11/2/2004",7,-1,48.3,50.7,-2.40000000000001
2004,"2004-10-26",48,48,"11/2/2004",7,0,48.3,50.7,-2.40000000000001
2004,"2004-10-27",46,48,"11/2/2004",6,-2,48.3,50.7,-2.40000000000001
2004,"2004-10-27",43,46,"11/2/2004",6,-3,48.3,50.7,-2.40000000000001
2004,"2004-10-27",49,46,"11/2/2004",6,3,48.3,50.7,-2.40000000000001
2004,"2004-10-27",48,49,"11/2/2004",6,-1,48.3,50.7,-2.40000000000001
2004,"2004-10-27",48,49,"11/2/2004",6,-1,48.3,50.7,-2.40000000000001
2004,"2004-10-27",48,47,"11/2/2004",6,1,48.3,50.7,-2.40000000000001
2004,"2004-10-27",46,48,"11/2/2004",6,-2,48.3,50.7,-2.40000000000001
2004,"2004-10-28",47,47,"11/2/2004",5,0,48.3,50.7,-2.40000000000001
2004,"2004-10-28",45,50,"11/2/2004",5,-5,48.3,50.7,-2.40000000000001
2004,"2004-10-28",45,45,"11/2/2004",5,0,48.3,50.7,-2.40000000000001
2004,"2004-10-28",45,50,"11/2/2004",5,-5,48.3,50.7,-2.40000000000001
2004,"2004-10-28",47,47,"11/2/2004",5,0,48.3,50.7,-2.40000000000001
2004,"2004-10-28",49,47,"11/2/2004",5,2,48.3,50.7,-2.40000000000001
2004,"2004-10-28",47,50,"11/2/2004",5,-3,48.3,50.7,-2.40000000000001
2004,"2004-10-28",47,50,"11/2/2004",5,-3,48.3,50.7,-2.40000000000001
2004,"2004-10-28",46,48,"11/2/2004",5,-2,48.3,50.7,-2.40000000000001
2004,"2004-10-28",45,49,"11/2/2004",5,-4,48.3,50.7,-2.40000000000001
2004,"2004-10-29",47,46,"11/2/2004",4,1,48.3,50.7,-2.40000000000001
2004,"2004-10-29",44,45,"11/2/2004",4,-1,48.3,50.7,-2.40000000000001
2004,"2004-10-29",45,47,"11/2/2004",4,-2,48.3,50.7,-2.40000000000001
2004,"2004-10-29",46,46,"11/2/2004",4,0,48.3,50.7,-2.40000000000001
2004,"2004-10-29",48,49,"11/2/2004",4,-1,48.3,50.7,-2.40000000000001
2004,"2004-10-29",48,49,"11/2/2004",4,-1,48.3,50.7,-2.40000000000001
2004,"2004-10-29",48,47,"11/2/2004",4,1,48.3,50.7,-2.40000000000001
2004,"2004-10-29",47,48,"11/2/2004",4,-1,48.3,50.7,-2.40000000000001
2004,"2004-10-29",45,51,"11/2/2004",4,-6,48.3,50.7,-2.40000000000001
2004,"2004-10-29",45,48,"11/2/2004",4,-3,48.3,50.7,-2.40000000000001
2004,"2004-10-30",48,48,"11/2/2004",3,0,48.3,50.7,-2.40000000000001
2004,"2004-10-30",42,47,"11/2/2004",3,-5,48.3,50.7,-2.40000000000001
2004,"2004-10-30",47,50,"11/2/2004",3,-3,48.3,50.7,-2.40000000000001
2004,"2004-10-30",47,46,"11/2/2004",3,1,48.3,50.7,-2.40000000000001
2004,"2004-10-30",47,45,"11/2/2004",3,2,48.3,50.7,-2.40000000000001
2004,"2004-10-30",48,47,"11/2/2004",3,1,48.3,50.7,-2.40000000000001
2004,"2004-10-30",48,48,"11/2/2004",3,0,48.3,50.7,-2.40000000000001
2004,"2004-10-30",48,49,"11/2/2004",3,-1,48.3,50.7,-2.40000000000001
2004,"2004-10-30",48,47,"11/2/2004",3,1,48.3,50.7,-2.40000000000001
2004,"2004-10-30",47,48,"11/2/2004",3,-1,48.3,50.7,-2.40000000000001
2004,"2004-10-30",49,48,"11/2/2004",3,1,48.3,50.7,-2.40000000000001
2004,"2004-10-30",49,48,"11/2/2004",3,1,48.3,50.7,-2.40000000000001
2004,"2004-10-30",45,48,"11/2/2004",3,-3,48.3,50.7,-2.40000000000001
2004,"2004-10-30",46,45,"11/2/2004",3,1,48.3,50.7,-2.40000000000001
2004,"2004-10-31",47,48,"11/2/2004",2,-1,48.3,50.7,-2.40000000000001
2004,"2004-10-31",49,48,"11/2/2004",2,1,48.3,50.7,-2.40000000000001
2004,"2004-10-31",48,48,"11/2/2004",2,0,48.3,50.7,-2.40000000000001
2004,"2004-10-31",46,49,"11/2/2004",2,-3,48.3,50.7,-2.40000000000001
2004,"2004-10-31",44,45,"11/2/2004",2,-1,48.3,50.7,-2.40000000000001
2004,"2004-10-31",48,46,"11/2/2004",2,2,48.3,50.7,-2.40000000000001
2004,"2004-10-31",48,45,"11/2/2004",2,3,48.3,50.7,-2.40000000000001
2004,"2004-10-31",48,47,"11/2/2004",2,1,48.3,50.7,-2.40000000000001
2004,"2004-10-31",45,49,"11/2/2004",2,-4,48.3,50.7,-2.40000000000001
2004,"2004-10-31",47,49,"11/2/2004",2,-2,48.3,50.7,-2.40000000000001
2004,"2004-10-31",48,47,"11/2/2004",2,1,48.3,50.7,-2.40000000000001
2004,"2004-10-31",47,48,"11/2/2004",2,-1,48.3,50.7,-2.40000000000001
2004,"2004-10-31",48,49,"11/2/2004",2,-1,48.3,50.7,-2.40000000000001
2004,"2004-10-31",48,49,"11/2/2004",2,-1,48.3,50.7,-2.40000000000001
2004,"2004-10-31",48,48,"11/2/2004",2,0,48.3,50.7,-2.40000000000001
2004,"2004-10-31",47,48,"11/2/2004",2,-1,48.3,50.7,-2.40000000000001
2004,"2004-11-01",50,49,"11/2/2004",1,1,48.3,50.7,-2.40000000000001
2004,"2004-11-01",48,48,"11/2/2004",1,0,48.3,50.7,-2.40000000000001
2004,"2004-11-01",46,50,"11/2/2004",1,-4,48.3,50.7,-2.40000000000001
2004,"2004-11-01",44,47,"11/2/2004",1,-3,48.3,50.7,-2.40000000000001
2008,"2007-10-29",43,43,"11/4/2008",372,0,52.9,45.7,7.2
2008,"2007-11-14",47,44,"11/4/2008",356,3,52.9,45.7,7.2
2008,"2007-12-09",48,48,"11/4/2008",331,0,52.9,45.7,7.2
2008,"2007-12-14",47,43,"11/4/2008",326,4,52.9,45.7,7.2
2008,"2007-12-16",43,45,"11/4/2008",324,-2,52.9,45.7,7.2
2008,"2007-12-19",40,44,"11/4/2008",321,-4,52.9,45.7,7.2
2008,"2008-01-10",49,48,"11/4/2008",299,1,52.9,45.7,7.2
2008,"2008-01-11",43,45,"11/4/2008",298,-2,52.9,45.7,7.2
2008,"2008-01-12",43,42,"11/4/2008",297,1,52.9,45.7,7.2
2008,"2008-01-13",45,50,"11/4/2008",296,-5,52.9,45.7,7.2
2008,"2008-01-22",42,42,"11/4/2008",287,0,52.9,45.7,7.2
2008,"2008-01-22",41,42,"11/4/2008",287,-1,52.9,45.7,7.2
2008,"2008-01-31",47,48,"11/4/2008",278,-1,52.9,45.7,7.2
2008,"2008-01-31",47,48,"11/4/2008",278,-1,52.9,45.7,7.2
2008,"2008-01-31",44,43,"11/4/2008",278,1,52.9,45.7,7.2
2008,"2008-02-01",47,48,"11/4/2008",277,-1,52.9,45.7,7.2
2008,"2008-02-02",45,43,"11/4/2008",276,2,52.9,45.7,7.2
2008,"2008-02-03",52,44,"11/4/2008",275,8,52.9,45.7,7.2
2008,"2008-02-04",48,41,"11/4/2008",274,7,52.9,45.7,7.2
2008,"2008-02-05",44,38,"11/4/2008",273,6,52.9,45.7,7.2
2008,"2008-02-06",46,43,"11/4/2008",272,3,52.9,45.7,7.2
2008,"2008-02-10",48,42,"11/4/2008",268,6,52.9,45.7,7.2
2008,"2008-02-10",50,46,"11/4/2008",268,4,52.9,45.7,7.2
2008,"2008-02-10",44,40,"11/4/2008",268,4,52.9,45.7,7.2
2008,"2008-02-12",49,39,"11/4/2008",266,10,52.9,45.7,7.2
2008,"2008-02-14",46,43,"11/4/2008",264,3,52.9,45.7,7.2
2008,"2008-02-16",47,40,"11/4/2008",262,7,52.9,45.7,7.2
2008,"2008-02-17",48,40,"11/4/2008",261,8,52.9,45.7,7.2
2008,"2008-02-18",46,43,"11/4/2008",260,3,52.9,45.7,7.2
2008,"2008-02-20",47,43,"11/4/2008",258,4,52.9,45.7,7.2
2008,"2008-02-20",45,44,"11/4/2008",258,1,52.9,45.7,7.2
2008,"2008-02-21",50,44,"11/4/2008",257,6,52.9,45.7,7.2
2008,"2008-02-22",43,46,"11/4/2008",256,-3,52.9,45.7,7.2
2008,"2008-02-24",51,41,"11/4/2008",254,10,52.9,45.7,7.2
2008,"2008-02-24",47,48,"11/4/2008",254,-1,52.9,45.7,7.2
2008,"2008-02-24",50,43,"11/4/2008",254,7,52.9,45.7,7.2
2008,"2008-02-24",50,38,"11/4/2008",254,12,52.9,45.7,7.2
2008,"2008-02-25",42,44,"11/4/2008",253,-2,52.9,45.7,7.2
2008,"2008-02-26",48,47,"11/4/2008",252,1,52.9,45.7,7.2
2008,"2008-02-26",43,44,"11/4/2008",252,-1,52.9,45.7,7.2
2008,"2008-02-26",43,46,"11/4/2008",252,-3,52.9,45.7,7.2
2008,"2008-03-01",43,48,"11/4/2008",248,-5,52.9,45.7,7.2
2008,"2008-03-02",53,42,"11/4/2008",247,11,52.9,45.7,7.2
2008,"2008-03-02",47,38,"11/4/2008",247,9,52.9,45.7,7.2
2008,"2008-03-04",46,46,"11/4/2008",245,0,52.9,45.7,7.2
2008,"2008-03-05",44,46,"11/4/2008",244,-2,52.9,45.7,7.2
2008,"2008-03-06",46,45,"11/4/2008",243,1,52.9,45.7,7.2
2008,"2008-03-09",43,45,"11/4/2008",240,-2,52.9,45.7,7.2
2008,"2008-03-09",44,45,"11/4/2008",240,-1,52.9,45.7,7.2
2008,"2008-03-10",47,44,"11/4/2008",239,3,52.9,45.7,7.2
2008,"2008-03-11",46,44,"11/4/2008",238,2,52.9,45.7,7.2
2008,"2008-03-13",44,45,"11/4/2008",236,-1,52.9,45.7,7.2
2008,"2008-03-14",40,46,"11/4/2008",235,-6,52.9,45.7,7.2
2008,"2008-03-16",47,46,"11/4/2008",233,1,52.9,45.7,7.2
2008,"2008-03-16",44,46,"11/4/2008",233,-2,52.9,45.7,7.2
2008,"2008-03-16",49,47,"11/4/2008",233,2,52.9,45.7,7.2
2008,"2008-03-17",42,48,"11/4/2008",232,-6,52.9,45.7,7.2
2008,"2008-03-18",48,43,"11/4/2008",231,5,52.9,45.7,7.2
2008,"2008-03-19",43,44,"11/4/2008",230,-1,52.9,45.7,7.2
2008,"2008-03-21",44,46,"11/4/2008",228,-2,52.9,45.7,7.2
2008,"2008-03-21",41,49,"11/4/2008",228,-8,52.9,45.7,7.2
2008,"2008-03-22",49,43,"11/4/2008",227,6,52.9,45.7,7.2
2008,"2008-03-24",39,33,"11/4/2008",225,6,52.9,45.7,7.2
2008,"2008-03-24",41,45,"11/4/2008",225,-4,52.9,45.7,7.2
2008,"2008-03-25",44,42,"11/4/2008",224,2,52.9,45.7,7.2
2008,"2008-03-25",41,51,"11/4/2008",224,-10,52.9,45.7,7.2
2008,"2008-03-26",42,44,"11/4/2008",223,-2,52.9,45.7,7.2
2008,"2008-03-27",46,49,"11/4/2008",222,-3,52.9,45.7,7.2
2008,"2008-03-27",44,46,"11/4/2008",222,-2,52.9,45.7,7.2
2008,"2008-03-27",42,48,"11/4/2008",222,-6,52.9,45.7,7.2
2008,"2008-03-29",44,47,"11/4/2008",220,-3,52.9,45.7,7.2
2008,"2008-03-31",44,46,"11/4/2008",218,-2,52.9,45.7,7.2
2008,"2008-04-01",44,46,"11/4/2008",217,-2,52.9,45.7,7.2
2008,"2008-04-02",47,42,"11/4/2008",216,5,52.9,45.7,7.2
2008,"2008-04-02",41,48,"11/4/2008",216,-7,52.9,45.7,7.2
2008,"2008-04-06",45,45,"11/4/2008",212,0,52.9,45.7,7.2
2008,"2008-04-06",44,44,"11/4/2008",212,0,52.9,45.7,7.2
2008,"2008-04-06",45,46,"11/4/2008",212,-1,52.9,45.7,7.2
2008,"2008-04-07",43,44,"11/4/2008",211,-1,52.9,45.7,7.2
2008,"2008-04-08",44,44,"11/4/2008",210,0,52.9,45.7,7.2
2008,"2008-04-09",45,45,"11/4/2008",209,0,52.9,45.7,7.2
2008,"2008-04-10",44,47,"11/4/2008",208,-3,52.9,45.7,7.2
2008,"2008-04-11",46,43,"11/4/2008",207,3,52.9,45.7,7.2
2008,"2008-04-12",41,35,"11/4/2008",206,6,52.9,45.7,7.2
2008,"2008-04-12",45,45,"11/4/2008",206,0,52.9,45.7,7.2
2008,"2008-04-13",49,44,"11/4/2008",205,5,52.9,45.7,7.2
2008,"2008-04-14",34,35,"11/4/2008",204,-1,52.9,45.7,7.2
2008,"2008-04-14",43,47,"11/4/2008",204,-4,52.9,45.7,7.2
2008,"2008-04-16",46,44,"11/4/2008",202,2,52.9,45.7,7.2
2008,"2008-04-16",42,45,"11/4/2008",202,-3,52.9,45.7,7.2
2008,"2008-04-17",48,47,"11/4/2008",201,1,52.9,45.7,7.2
2008,"2008-04-17",48,44,"11/4/2008",201,4,52.9,45.7,7.2
2008,"2008-04-18",41,48,"11/4/2008",200,-7,52.9,45.7,7.2
2008,"2008-04-20",49,44,"11/4/2008",198,5,52.9,45.7,7.2
2008,"2008-04-20",45,44,"11/4/2008",198,1,52.9,45.7,7.2
2008,"2008-04-21",45,45,"11/4/2008",197,0,52.9,45.7,7.2
2008,"2008-04-22",42,45,"11/4/2008",196,-3,52.9,45.7,7.2
2008,"2008-04-22",44,47,"11/4/2008",196,-3,52.9,45.7,7.2
2008,"2008-04-25",47,44,"11/4/2008",193,3,52.9,45.7,7.2
2008,"2008-04-26",45,45,"11/4/2008",192,0,52.9,45.7,7.2
2008,"2008-04-26",46,46,"11/4/2008",192,0,52.9,45.7,7.2
2008,"2008-04-27",46,44,"11/4/2008",191,2,52.9,45.7,7.2
2008,"2008-04-27",50,44,"11/4/2008",191,6,52.9,45.7,7.2
2008,"2008-04-28",46,43,"11/4/2008",190,3,52.9,45.7,7.2
2008,"2008-04-29",45,45,"11/4/2008",189,0,52.9,45.7,7.2
2008,"2008-04-29",43,46,"11/4/2008",189,-3,52.9,45.7,7.2
2008,"2008-04-30",49,45,"11/4/2008",188,4,52.9,45.7,7.2
2008,"2008-04-30",43,46,"11/4/2008",188,-3,52.9,45.7,7.2
2008,"2008-05-01",42,48,"11/4/2008",187,-6,52.9,45.7,7.2
2008,"2008-05-02",43,41,"11/4/2008",186,2,52.9,45.7,7.2
2008,"2008-05-03",47,48,"11/4/2008",185,-1,52.9,45.7,7.2
2008,"2008-05-03",47,43,"11/4/2008",185,4,52.9,45.7,7.2
2008,"2008-05-03",50,38,"11/4/2008",185,12,52.9,45.7,7.2
2008,"2008-05-04",46,42,"11/4/2008",184,4,52.9,45.7,7.2
2008,"2008-05-04",43,47,"11/4/2008",184,-4,52.9,45.7,7.2
2008,"2008-05-06",46,45,"11/4/2008",182,1,52.9,45.7,7.2
2008,"2008-05-06",39,46,"11/4/2008",182,-7,52.9,45.7,7.2
2008,"2008-05-08",46,40,"11/4/2008",180,6,52.9,45.7,7.2
2008,"2008-05-08",47,44,"11/4/2008",180,3,52.9,45.7,7.2
2008,"2008-05-10",48,43,"11/4/2008",178,5,52.9,45.7,7.2
2008,"2008-05-11",51,44,"11/4/2008",177,7,52.9,45.7,7.2
2008,"2008-05-11",47,43,"11/4/2008",177,4,52.9,45.7,7.2
2008,"2008-05-12",47,40,"11/4/2008",176,7,52.9,45.7,7.2
2008,"2008-05-12",47,46,"11/4/2008",176,1,52.9,45.7,7.2
2008,"2008-05-13",48,46,"11/4/2008",175,2,52.9,45.7,7.2
2008,"2008-05-14",49,47,"11/4/2008",174,2,52.9,45.7,7.2
2008,"2008-05-15",39,42,"11/4/2008",173,-3,52.9,45.7,7.2
2008,"2008-05-16",44,47,"11/4/2008",172,-3,52.9,45.7,7.2
2008,"2008-05-16",44,45,"11/4/2008",172,-1,52.9,45.7,7.2
2008,"2008-05-18",48,37,"11/4/2008",170,11,52.9,45.7,7.2
2008,"2008-05-18",48,40,"11/4/2008",170,8,52.9,45.7,7.2
2008,"2008-05-19",39,35,"11/4/2008",169,4,52.9,45.7,7.2
2008,"2008-05-20",44,45,"11/4/2008",168,-1,52.9,45.7,7.2
2008,"2008-05-21",47,44,"11/4/2008",167,3,52.9,45.7,7.2
2008,"2008-05-21",43,41,"11/4/2008",167,2,52.9,45.7,7.2
2008,"2008-05-22",46,46,"11/4/2008",166,0,52.9,45.7,7.2
2008,"2008-05-24",44,46,"11/4/2008",164,-2,52.9,45.7,7.2
2008,"2008-05-25",47,44,"11/4/2008",163,3,52.9,45.7,7.2
2008,"2008-05-26",47,47,"11/4/2008",162,0,52.9,45.7,7.2
2008,"2008-05-27",45,46,"11/4/2008",161,-1,52.9,45.7,7.2
2008,"2008-05-28",38,48,"11/4/2008",160,-10,52.9,45.7,7.2
2008,"2008-05-28",44,40,"11/4/2008",160,4,52.9,45.7,7.2
2008,"2008-05-28",42,47,"11/4/2008",160,-5,52.9,45.7,7.2
2008,"2008-05-31",44,43,"11/4/2008",157,1,52.9,45.7,7.2
2008,"2008-06-01",46,46,"11/4/2008",156,0,52.9,45.7,7.2
2008,"2008-06-01",49,44,"11/4/2008",156,5,52.9,45.7,7.2
2008,"2008-06-01",45,45,"11/4/2008",156,0,52.9,45.7,7.2
2008,"2008-06-03",48,42,"11/4/2008",154,6,52.9,45.7,7.2
2008,"2008-06-04",47,45,"11/4/2008",153,2,52.9,45.7,7.2
2008,"2008-06-05",49,46,"11/4/2008",152,3,52.9,45.7,7.2
2008,"2008-06-06",46,45,"11/4/2008",151,1,52.9,45.7,7.2
2008,"2008-06-07",50,43,"11/4/2008",150,7,52.9,45.7,7.2
2008,"2008-06-08",44,42,"11/4/2008",149,2,52.9,45.7,7.2
2008,"2008-06-08",43,40,"11/4/2008",149,3,52.9,45.7,7.2
2008,"2008-06-09",47,41,"11/4/2008",148,6,52.9,45.7,7.2
2008,"2008-06-09",48,41,"11/4/2008",148,7,52.9,45.7,7.2
2008,"2008-06-10",49,44,"11/4/2008",147,5,52.9,45.7,7.2
2008,"2008-06-11",50,43,"11/4/2008",146,7,52.9,45.7,7.2
2008,"2008-06-11",37,33,"11/4/2008",146,4,52.9,45.7,7.2
2008,"2008-06-12",46,43,"11/4/2008",145,3,52.9,45.7,7.2
2008,"2008-06-13",42,32,"11/4/2008",144,10,52.9,45.7,7.2
2008,"2008-06-13",49,43,"11/4/2008",144,6,52.9,45.7,7.2
2008,"2008-06-14",47,42,"11/4/2008",143,5,52.9,45.7,7.2
2008,"2008-06-15",47,48,"11/4/2008",142,-1,52.9,45.7,7.2
2008,"2008-06-15",46,42,"11/4/2008",142,4,52.9,45.7,7.2
2008,"2008-06-15",44,40,"11/4/2008",142,4,52.9,45.7,7.2
2008,"2008-06-16",48,44,"11/4/2008",141,4,52.9,45.7,7.2
2008,"2008-06-17",37,34,"11/4/2008",140,3,52.9,45.7,7.2
2008,"2008-06-18",42,39,"11/4/2008",139,3,52.9,45.7,7.2
2008,"2008-06-19",46,44,"11/4/2008",138,2,52.9,45.7,7.2
2008,"2008-06-19",51,36,"11/4/2008",138,15,52.9,45.7,7.2
2008,"2008-06-19",48,44,"11/4/2008",138,4,52.9,45.7,7.2
2008,"2008-06-19",50,44,"11/4/2008",138,6,52.9,45.7,7.2
2008,"2008-06-22",46,43,"11/4/2008",135,3,52.9,45.7,7.2
2008,"2008-06-22",42,36,"11/4/2008",135,6,52.9,45.7,7.2
2008,"2008-06-22",49,43,"11/4/2008",135,6,52.9,45.7,7.2
2008,"2008-06-23",49,37,"11/4/2008",134,12,52.9,45.7,7.2
2008,"2008-06-23",37,35,"11/4/2008",134,2,52.9,45.7,7.2
2008,"2008-06-25",49,45,"11/4/2008",132,4,52.9,45.7,7.2
2008,"2008-06-25",47,43,"11/4/2008",132,4,52.9,45.7,7.2
2008,"2008-06-25",44,44,"11/4/2008",132,0,52.9,45.7,7.2
2008,"2008-06-25",36,34,"11/4/2008",132,2,52.9,45.7,7.2
2008,"2008-06-25",49,45,"11/4/2008",132,4,52.9,45.7,7.2
2008,"2008-06-28",49,43,"11/4/2008",129,6,52.9,45.7,7.2
2008,"2008-06-29",50,45,"11/4/2008",128,5,52.9,45.7,7.2
2008,"2008-06-29",47,42,"11/4/2008",128,5,52.9,45.7,7.2
2008,"2008-06-29",48,40,"11/4/2008",128,8,52.9,45.7,7.2
2008,"2008-06-29",46,38,"11/4/2008",128,8,52.9,45.7,7.2
2008,"2008-07-01",49,44,"11/4/2008",126,5,52.9,45.7,7.2
2008,"2008-07-02",47,43,"11/4/2008",125,4,52.9,45.7,7.2
2008,"2008-07-02",37,34,"11/4/2008",125,3,52.9,45.7,7.2
2008,"2008-07-06",47,43,"11/4/2008",121,4,52.9,45.7,7.2
2008,"2008-07-07",49,43,"11/4/2008",120,6,52.9,45.7,7.2
2008,"2008-07-09",46,43,"11/4/2008",118,3,52.9,45.7,7.2
2008,"2008-07-09",39,38,"11/4/2008",118,1,52.9,45.7,7.2
2008,"2008-07-10",44,41,"11/4/2008",117,3,52.9,45.7,7.2
2008,"2008-07-10",47,45,"11/4/2008",117,2,52.9,45.7,7.2
2008,"2008-07-11",44,35,"11/4/2008",116,9,52.9,45.7,7.2
2008,"2008-07-11",40,37,"11/4/2008",116,3,52.9,45.7,7.2
2008,"2008-07-12",46,43,"11/4/2008",115,3,52.9,45.7,7.2
2008,"2008-07-13",49,46,"11/4/2008",114,3,52.9,45.7,7.2
2008,"2008-07-13",50,41,"11/4/2008",114,9,52.9,45.7,7.2
2008,"2008-07-13",47,40,"11/4/2008",114,7,52.9,45.7,7.2
2008,"2008-07-13",47,46,"11/4/2008",114,1,52.9,45.7,7.2
2008,"2008-07-14",45,39,"11/4/2008",113,6,52.9,45.7,7.2
2008,"2008-07-15",47,44,"11/4/2008",112,3,52.9,45.7,7.2
2008,"2008-07-16",46,46,"11/4/2008",111,0,52.9,45.7,7.2
2008,"2008-07-17",41,36,"11/4/2008",110,5,52.9,45.7,7.2
2008,"2008-07-18",45,43,"11/4/2008",109,2,52.9,45.7,7.2
2008,"2008-07-19",47,45,"11/4/2008",108,2,52.9,45.7,7.2
2008,"2008-07-21",47,41,"11/4/2008",106,6,52.9,45.7,7.2
2008,"2008-07-21",45,42,"11/4/2008",106,3,52.9,45.7,7.2
2008,"2008-07-22",47,45,"11/4/2008",105,2,52.9,45.7,7.2
2008,"2008-07-23",40,37,"11/4/2008",104,3,52.9,45.7,7.2
2008,"2008-07-24",49,43,"11/4/2008",103,6,52.9,45.7,7.2
2008,"2008-07-24",47,41,"11/4/2008",103,6,52.9,45.7,7.2
2008,"2008-07-24",41,38,"11/4/2008",103,3,52.9,45.7,7.2
2008,"2008-07-25",49,43,"11/4/2008",102,6,52.9,45.7,7.2
2008,"2008-07-27",51,39,"11/4/2008",100,12,52.9,45.7,7.2
2008,"2008-07-27",45,49,"11/4/2008",100,-4,52.9,45.7,7.2
2008,"2008-07-27",48,40,"11/4/2008",100,8,52.9,45.7,7.2
2008,"2008-07-27",47,42,"11/4/2008",100,5,52.9,45.7,7.2
2008,"2008-07-28",47,46,"11/4/2008",99,1,52.9,45.7,7.2
2008,"2008-07-29",51,44,"11/4/2008",98,7,52.9,45.7,7.2
2008,"2008-07-29",44,37,"11/4/2008",98,7,52.9,45.7,7.2
2008,"2008-07-30",45,44,"11/4/2008",97,1,52.9,45.7,7.2
2008,"2008-07-31",47,46,"11/4/2008",96,1,52.9,45.7,7.2
2008,"2008-08-01",41,42,"11/4/2008",95,-1,52.9,45.7,7.2
2008,"2008-08-02",45,44,"11/4/2008",94,1,52.9,45.7,7.2
2008,"2008-08-03",46,47,"11/4/2008",93,-1,52.9,45.7,7.2
2008,"2008-08-04",47,41,"11/4/2008",92,6,52.9,45.7,7.2
2008,"2008-08-04",46,41,"11/4/2008",92,5,52.9,45.7,7.2
2008,"2008-08-05",46,44,"11/4/2008",91,2,52.9,45.7,7.2
2008,"2008-08-05",45,39,"11/4/2008",91,6,52.9,45.7,7.2
2008,"2008-08-06",42,39,"11/4/2008",90,3,52.9,45.7,7.2
2008,"2008-08-06",47,46,"11/4/2008",90,1,52.9,45.7,7.2
2008,"2008-08-07",47,38,"11/4/2008",89,9,52.9,45.7,7.2
2008,"2008-08-07",38,27,"11/4/2008",89,11,52.9,45.7,7.2
2008,"2008-08-08",47,42,"11/4/2008",88,5,52.9,45.7,7.2
2008,"2008-08-09",43,38,"11/4/2008",87,5,52.9,45.7,7.2
2008,"2008-08-09",48,46,"11/4/2008",87,2,52.9,45.7,7.2
2008,"2008-08-10",46,43,"11/4/2008",86,3,52.9,45.7,7.2
2008,"2008-08-11",47,42,"11/4/2008",85,5,52.9,45.7,7.2
2008,"2008-08-12",48,46,"11/4/2008",84,2,52.9,45.7,7.2
2008,"2008-08-13",41,40,"11/4/2008",83,1,52.9,45.7,7.2
2008,"2008-08-14",46,47,"11/4/2008",82,-1,52.9,45.7,7.2
2008,"2008-08-14",44,44,"11/4/2008",82,0,52.9,45.7,7.2
2008,"2008-08-14",44,42,"11/4/2008",82,2,52.9,45.7,7.2
2008,"2008-08-15",46,45,"11/4/2008",81,1,52.9,45.7,7.2
2008,"2008-08-16",41,46,"11/4/2008",80,-5,52.9,45.7,7.2
2008,"2008-08-17",47,42,"11/4/2008",79,5,52.9,45.7,7.2
2008,"2008-08-17",46,43,"11/4/2008",79,3,52.9,45.7,7.2
2008,"2008-08-18",45,42,"11/4/2008",78,3,52.9,45.7,7.2
2008,"2008-08-18",45,43,"11/4/2008",78,2,52.9,45.7,7.2
2008,"2008-08-18",47,45,"11/4/2008",78,2,52.9,45.7,7.2
2008,"2008-08-19",45,42,"11/4/2008",77,3,52.9,45.7,7.2
2008,"2008-08-20",45,44,"11/4/2008",76,1,52.9,45.7,7.2
2008,"2008-08-20",39,38,"11/4/2008",76,1,52.9,45.7,7.2
2008,"2008-08-20",42,39,"11/4/2008",76,3,52.9,45.7,7.2
2008,"2008-08-21",47,46,"11/4/2008",75,1,52.9,45.7,7.2
2008,"2008-08-22",49,45,"11/4/2008",74,4,52.9,45.7,7.2
2008,"2008-08-23",45,45,"11/4/2008",73,0,52.9,45.7,7.2
2008,"2008-08-23",48,45,"11/4/2008",73,3,52.9,45.7,7.2
2008,"2008-08-24",47,47,"11/4/2008",72,0,52.9,45.7,7.2
2008,"2008-08-24",44,40,"11/4/2008",72,4,52.9,45.7,7.2
2008,"2008-08-24",46,44,"11/4/2008",72,2,52.9,45.7,7.2
2008,"2008-08-24",48,45,"11/4/2008",72,3,52.9,45.7,7.2
2008,"2008-08-26",45,44,"11/4/2008",70,1,52.9,45.7,7.2
2008,"2008-08-26",41,36,"11/4/2008",70,5,52.9,45.7,7.2
2008,"2008-08-27",47,47,"11/4/2008",69,0,52.9,45.7,7.2
2008,"2008-08-29",49,41,"11/4/2008",67,8,52.9,45.7,7.2
2008,"2008-08-30",45,47,"11/4/2008",66,-2,52.9,45.7,7.2
2008,"2008-08-30",49,46,"11/4/2008",66,3,52.9,45.7,7.2
2008,"2008-08-31",49,48,"11/4/2008",65,1,52.9,45.7,7.2
2008,"2008-08-31",48,39,"11/4/2008",65,9,52.9,45.7,7.2
2008,"2008-08-31",48,40,"11/4/2008",65,8,52.9,45.7,7.2
2008,"2008-09-01",49,43,"11/4/2008",64,6,52.9,45.7,7.2
2008,"2008-09-01",51,45,"11/4/2008",64,6,52.9,45.7,7.2
2008,"2008-09-03",49,44,"11/4/2008",62,5,52.9,45.7,7.2
2008,"2008-09-03",49,42,"11/4/2008",62,7,52.9,45.7,7.2
2008,"2008-09-03",42,42,"11/4/2008",62,0,52.9,45.7,7.2
2008,"2008-09-03",42,39,"11/4/2008",62,3,52.9,45.7,7.2
2008,"2008-09-04",46,40,"11/4/2008",61,6,52.9,45.7,7.2
2008,"2008-09-04",48,46,"11/4/2008",61,2,52.9,45.7,7.2
2008,"2008-09-05",40,36,"11/4/2008",60,4,52.9,45.7,7.2
2008,"2008-09-06",46,50,"11/4/2008",59,-4,52.9,45.7,7.2
2008,"2008-09-06",45,48,"11/4/2008",59,-3,52.9,45.7,7.2
2008,"2008-09-07",44,54,"11/4/2008",58,-10,52.9,45.7,7.2
2008,"2008-09-07",48,48,"11/4/2008",58,0,52.9,45.7,7.2
2008,"2008-09-07",47,49,"11/4/2008",58,-2,52.9,45.7,7.2
2008,"2008-09-07",45,40,"11/4/2008",58,5,52.9,45.7,7.2
2008,"2008-09-07",47,48,"11/4/2008",58,-1,52.9,45.7,7.2
2008,"2008-09-08",47,46,"11/4/2008",57,1,52.9,45.7,7.2
2008,"2008-09-08",46,46,"11/4/2008",57,0,52.9,45.7,7.2
2008,"2008-09-08",43,46,"11/4/2008",57,-3,52.9,45.7,7.2
2008,"2008-09-08",47,46,"11/4/2008",57,1,52.9,45.7,7.2
2008,"2008-09-09",45,46,"11/4/2008",56,-1,52.9,45.7,7.2
2008,"2008-09-09",43,48,"11/4/2008",56,-5,52.9,45.7,7.2
2008,"2008-09-09",45,45,"11/4/2008",56,0,52.9,45.7,7.2
2008,"2008-09-09",42,45,"11/4/2008",56,-3,52.9,45.7,7.2
2008,"2008-09-09",41,40,"11/4/2008",56,1,52.9,45.7,7.2
2008,"2008-09-10",46,48,"11/4/2008",55,-2,52.9,45.7,7.2
2008,"2008-09-10",47,45,"11/4/2008",55,2,52.9,45.7,7.2
2008,"2008-09-10",44,48,"11/4/2008",55,-4,52.9,45.7,7.2
2008,"2008-09-10",48,48,"11/4/2008",55,0,52.9,45.7,7.2
2008,"2008-09-11",46,46,"11/4/2008",54,0,52.9,45.7,7.2
2008,"2008-09-12",45,47,"11/4/2008",53,-2,52.9,45.7,7.2
2008,"2008-09-12",44,45,"11/4/2008",53,-1,52.9,45.7,7.2
2008,"2008-09-13",47,45,"11/4/2008",52,2,52.9,45.7,7.2
2008,"2008-09-13",47,45,"11/4/2008",52,2,52.9,45.7,7.2
2008,"2008-09-13",47,50,"11/4/2008",52,-3,52.9,45.7,7.2
2008,"2008-09-14",47,45,"11/4/2008",51,2,52.9,45.7,7.2
2008,"2008-09-14",46,46,"11/4/2008",51,0,52.9,45.7,7.2
2008,"2008-09-15",45,45,"11/4/2008",50,0,52.9,45.7,7.2
2008,"2008-09-15",45,48,"11/4/2008",50,-3,52.9,45.7,7.2
2008,"2008-09-15",46,47,"11/4/2008",50,-1,52.9,45.7,7.2
2008,"2008-09-15",46,42,"11/4/2008",50,4,52.9,45.7,7.2
2008,"2008-09-15",40,41,"11/4/2008",50,-1,52.9,45.7,7.2
2008,"2008-09-16",48,44,"11/4/2008",49,4,52.9,45.7,7.2
2008,"2008-09-16",49,45,"11/4/2008",49,4,52.9,45.7,7.2
2008,"2008-09-16",49,44,"11/4/2008",49,5,52.9,45.7,7.2
2008,"2008-09-16",43,45,"11/4/2008",49,-2,52.9,45.7,7.2
2008,"2008-09-16",47,48,"11/4/2008",49,-1,52.9,45.7,7.2
2008,"2008-09-17",46,45,"11/4/2008",48,1,52.9,45.7,7.2
2008,"2008-09-17",45,47,"11/4/2008",48,-2,52.9,45.7,7.2
2008,"2008-09-18",49,44,"11/4/2008",47,5,52.9,45.7,7.2
2008,"2008-09-18",45,44,"11/4/2008",47,1,52.9,45.7,7.2
2008,"2008-09-19",50,42,"11/4/2008",46,8,52.9,45.7,7.2
2008,"2008-09-19",48,47,"11/4/2008",46,1,52.9,45.7,7.2
2008,"2008-09-20",47,43,"11/4/2008",45,4,52.9,45.7,7.2
2008,"2008-09-21",51,47,"11/4/2008",44,4,52.9,45.7,7.2
2008,"2008-09-21",48,44,"11/4/2008",44,4,52.9,45.7,7.2
2008,"2008-09-21",47,42,"11/4/2008",44,5,52.9,45.7,7.2
2008,"2008-09-21",45,47,"11/4/2008",44,-2,52.9,45.7,7.2
2008,"2008-09-22",49,43,"11/4/2008",43,6,52.9,45.7,7.2
2008,"2008-09-22",52,43,"11/4/2008",43,9,52.9,45.7,7.2
2008,"2008-09-22",47,46,"11/4/2008",43,1,52.9,45.7,7.2
2008,"2008-09-22",48,46,"11/4/2008",43,2,52.9,45.7,7.2
2008,"2008-09-22",49,45,"11/4/2008",43,4,52.9,45.7,7.2
2008,"2008-09-22",48,46,"11/4/2008",43,2,52.9,45.7,7.2
2008,"2008-09-22",44,43,"11/4/2008",43,1,52.9,45.7,7.2
2008,"2008-09-22",48,48,"11/4/2008",43,0,52.9,45.7,7.2
2008,"2008-09-23",47,43,"11/4/2008",42,4,52.9,45.7,7.2
2008,"2008-09-23",45,39,"11/4/2008",42,6,52.9,45.7,7.2
2008,"2008-09-24",47,44,"11/4/2008",41,3,52.9,45.7,7.2
2008,"2008-09-24",47,48,"11/4/2008",41,-1,52.9,45.7,7.2
2008,"2008-09-24",46,46,"11/4/2008",41,0,52.9,45.7,7.2
2008,"2008-09-24",46,43,"11/4/2008",41,3,52.9,45.7,7.2
2008,"2008-09-24",47,43,"11/4/2008",41,4,52.9,45.7,7.2
2008,"2008-09-24",48,43,"11/4/2008",41,5,52.9,45.7,7.2
2008,"2008-09-25",48,43,"11/4/2008",40,5,52.9,45.7,7.2
2008,"2008-09-25",44,46,"11/4/2008",40,-2,52.9,45.7,7.2
2008,"2008-09-25",50,45,"11/4/2008",40,5,52.9,45.7,7.2
2008,"2008-09-27",47,46,"11/4/2008",38,1,52.9,45.7,7.2
2008,"2008-09-27",50,42,"11/4/2008",38,8,52.9,45.7,7.2
2008,"2008-09-27",47,42,"11/4/2008",38,5,52.9,45.7,7.2
2008,"2008-09-28",51,42,"11/4/2008",37,9,52.9,45.7,7.2
2008,"2008-09-28",50,45,"11/4/2008",37,5,52.9,45.7,7.2
2008,"2008-09-29",50,46,"11/4/2008",36,4,52.9,45.7,7.2
2008,"2008-09-29",50,43,"11/4/2008",36,7,52.9,45.7,7.2
2008,"2008-09-29",49,45,"11/4/2008",36,4,52.9,45.7,7.2
2008,"2008-09-29",47,42,"11/4/2008",36,5,52.9,45.7,7.2
2008,"2008-09-29",49,43,"11/4/2008",36,6,52.9,45.7,7.2
2008,"2008-09-29",46,42,"11/4/2008",36,4,52.9,45.7,7.2
2008,"2008-09-30",49,45,"11/4/2008",35,4,52.9,45.7,7.2
2008,"2008-09-30",48,41,"11/4/2008",35,7,52.9,45.7,7.2
2008,"2008-09-30",49,44,"11/4/2008",35,5,52.9,45.7,7.2
2008,"2008-09-30",48,46,"11/4/2008",35,2,52.9,45.7,7.2
2008,"2008-09-30",48,44,"11/4/2008",35,4,52.9,45.7,7.2
2008,"2008-09-30",50,41,"11/4/2008",35,9,52.9,45.7,7.2
2008,"2008-09-30",47,42,"11/4/2008",35,5,52.9,45.7,7.2
2008,"2008-10-01",51,40,"11/4/2008",34,11,52.9,45.7,7.2
2008,"2008-10-01",51,44,"11/4/2008",34,7,52.9,45.7,7.2
2008,"2008-10-03",48,44,"11/4/2008",32,4,52.9,45.7,7.2
2008,"2008-10-03",50,42,"11/4/2008",32,8,52.9,45.7,7.2
2008,"2008-10-03",48,41,"11/4/2008",32,7,52.9,45.7,7.2
2008,"2008-10-04",52,40,"11/4/2008",31,12,52.9,45.7,7.2
2008,"2008-10-04",51,44,"11/4/2008",31,7,52.9,45.7,7.2
2008,"2008-10-05",48,45,"11/4/2008",30,3,52.9,45.7,7.2
2008,"2008-10-05",53,45,"11/4/2008",30,8,52.9,45.7,7.2
2008,"2008-10-05",49,43,"11/4/2008",30,6,52.9,45.7,7.2
2008,"2008-10-05",48,45,"11/4/2008",30,3,52.9,45.7,7.2
2008,"2008-10-06",49,45,"11/4/2008",29,4,52.9,45.7,7.2
2008,"2008-10-06",46,43,"11/4/2008",29,3,52.9,45.7,7.2
2008,"2008-10-06",51,42,"11/4/2008",29,9,52.9,45.7,7.2
2008,"2008-10-06",48,43,"11/4/2008",29,5,52.9,45.7,7.2
2008,"2008-10-06",50,43,"11/4/2008",29,7,52.9,45.7,7.2
2008,"2008-10-06",46,44,"11/4/2008",29,2,52.9,45.7,7.2
2008,"2008-10-06",47,40,"11/4/2008",29,7,52.9,45.7,7.2
2008,"2008-10-07",51,41,"11/4/2008",28,10,52.9,45.7,7.2
2008,"2008-10-07",51,45,"11/4/2008",28,6,52.9,45.7,7.2
2008,"2008-10-09",52,41,"11/4/2008",26,11,52.9,45.7,7.2
2008,"2008-10-09",48,41,"11/4/2008",26,7,52.9,45.7,7.2
2008,"2008-10-09",51,41,"11/4/2008",26,10,52.9,45.7,7.2
2008,"2008-10-09",48,43,"11/4/2008",26,5,52.9,45.7,7.2
2008,"2008-10-09",46,39,"11/4/2008",26,7,52.9,45.7,7.2
2008,"2008-10-10",52,40,"11/4/2008",25,12,52.9,45.7,7.2
2008,"2008-10-10",52,45,"11/4/2008",25,7,52.9,45.7,7.2
2008,"2008-10-11",53,43,"11/4/2008",24,10,52.9,45.7,7.2
2008,"2008-10-12",52,45,"11/4/2008",23,7,52.9,45.7,7.2
2008,"2008-10-12",51,45,"11/4/2008",23,6,52.9,45.7,7.2
2008,"2008-10-12",48,42,"11/4/2008",23,6,52.9,45.7,7.2
2008,"2008-10-12",50,40,"11/4/2008",23,10,52.9,45.7,7.2
2008,"2008-10-12",48,42,"11/4/2008",23,6,52.9,45.7,7.2
2008,"2008-10-12",51,43,"11/4/2008",23,8,52.9,45.7,7.2
2008,"2008-10-12",49,42,"11/4/2008",23,7,52.9,45.7,7.2
2008,"2008-10-13",52,41,"11/4/2008",22,11,52.9,45.7,7.2
2008,"2008-10-13",50,45,"11/4/2008",22,5,52.9,45.7,7.2
2008,"2008-10-13",53,39,"11/4/2008",22,14,52.9,45.7,7.2
2008,"2008-10-13",50,41,"11/4/2008",22,9,52.9,45.7,7.2
2008,"2008-10-13",49,43,"11/4/2008",22,6,52.9,45.7,7.2
2008,"2008-10-13",48,39,"11/4/2008",22,9,52.9,45.7,7.2
2008,"2008-10-13",42,39,"11/4/2008",22,3,52.9,45.7,7.2
2008,"2008-10-13",50,45,"11/4/2008",22,5,52.9,45.7,7.2
2008,"2008-10-15",51,45,"11/4/2008",20,6,52.9,45.7,7.2
2008,"2008-10-15",49,41,"11/4/2008",20,8,52.9,45.7,7.2
2008,"2008-10-16",52,42,"11/4/2008",19,10,52.9,45.7,7.2
2008,"2008-10-16",46,41,"11/4/2008",19,5,52.9,45.7,7.2
2008,"2008-10-16",50,46,"11/4/2008",19,4,52.9,45.7,7.2
2008,"2008-10-17",48,44,"11/4/2008",18,4,52.9,45.7,7.2
2008,"2008-10-18",51,44,"11/4/2008",17,7,52.9,45.7,7.2
2008,"2008-10-18",48,41,"11/4/2008",17,7,52.9,45.7,7.2
2008,"2008-10-19",51,46,"11/4/2008",16,5,52.9,45.7,7.2
2008,"2008-10-19",49,44,"11/4/2008",16,5,52.9,45.7,7.2
2008,"2008-10-19",50,42,"11/4/2008",16,8,52.9,45.7,7.2
2008,"2008-10-19",49,45,"11/4/2008",16,4,52.9,45.7,7.2
2008,"2008-10-19",53,39,"11/4/2008",16,14,52.9,45.7,7.2
2008,"2008-10-19",50,46,"11/4/2008",16,4,52.9,45.7,7.2
2008,"2008-10-19",50,45,"11/4/2008",16,5,52.9,45.7,7.2
2008,"2008-10-20",50,44,"11/4/2008",15,6,52.9,45.7,7.2
2008,"2008-10-20",52,42,"11/4/2008",15,10,52.9,45.7,7.2
2008,"2008-10-20",44,43,"11/4/2008",15,1,52.9,45.7,7.2
2008,"2008-10-20",49,45,"11/4/2008",15,4,52.9,45.7,7.2
2008,"2008-10-20",50,42,"11/4/2008",15,8,52.9,45.7,7.2
2008,"2008-10-20",50,42,"11/4/2008",15,8,52.9,45.7,7.2
2008,"2008-10-21",54,43,"11/4/2008",14,11,52.9,45.7,7.2
2008,"2008-10-21",52,44,"11/4/2008",14,8,52.9,45.7,7.2
2008,"2008-10-21",49,41,"11/4/2008",14,8,52.9,45.7,7.2
2008,"2008-10-21",49,40,"11/4/2008",14,9,52.9,45.7,7.2
2008,"2008-10-21",47,42,"11/4/2008",14,5,52.9,45.7,7.2
2008,"2008-10-21",46,42,"11/4/2008",14,4,52.9,45.7,7.2
2008,"2008-10-22",51,41,"11/4/2008",13,10,52.9,45.7,7.2
2008,"2008-10-22",52,43,"11/4/2008",13,9,52.9,45.7,7.2
2008,"2008-10-22",52,39,"11/4/2008",13,13,52.9,45.7,7.2
2008,"2008-10-22",52,45,"11/4/2008",13,7,52.9,45.7,7.2
2008,"2008-10-23",52,43,"11/4/2008",12,9,52.9,45.7,7.2
2008,"2008-10-23",53,41,"11/4/2008",12,12,52.9,45.7,7.2
2008,"2008-10-24",50,43,"11/4/2008",11,7,52.9,45.7,7.2
2008,"2008-10-24",51,43,"11/4/2008",11,8,52.9,45.7,7.2
2008,"2008-10-24",51,42,"11/4/2008",11,9,52.9,45.7,7.2
2008,"2008-10-25",52,45,"11/4/2008",10,7,52.9,45.7,7.2
2008,"2008-10-25",51,40,"11/4/2008",10,11,52.9,45.7,7.2
2008,"2008-10-25",52,44,"11/4/2008",10,8,52.9,45.7,7.2
2008,"2008-10-26",49,46,"11/4/2008",9,3,52.9,45.7,7.2
2008,"2008-10-26",53,38,"11/4/2008",9,15,52.9,45.7,7.2
2008,"2008-10-26",47,44,"11/4/2008",9,3,52.9,45.7,7.2
2008,"2008-10-27",50,44,"11/4/2008",8,6,52.9,45.7,7.2
2008,"2008-10-27",51,44,"11/4/2008",8,7,52.9,45.7,7.2
2008,"2008-10-27",49,42,"11/4/2008",8,7,52.9,45.7,7.2
2008,"2008-10-27",50,45,"11/4/2008",8,5,52.9,45.7,7.2
2008,"2008-10-27",49,45,"11/4/2008",8,4,52.9,45.7,7.2
2008,"2008-10-27",50,42,"11/4/2008",8,8,52.9,45.7,7.2
2008,"2008-10-27",48,42,"11/4/2008",8,6,52.9,45.7,7.2
2008,"2008-10-27",44,38,"11/4/2008",8,6,52.9,45.7,7.2
2008,"2008-10-28",50,44,"11/4/2008",7,6,52.9,45.7,7.2
2008,"2008-10-28",50,47,"11/4/2008",7,3,52.9,45.7,7.2
2008,"2008-10-29",52,44,"11/4/2008",6,8,52.9,45.7,7.2
2008,"2008-10-29",50,43,"11/4/2008",6,7,52.9,45.7,7.2
2008,"2008-10-29",47,44,"11/4/2008",6,3,52.9,45.7,7.2
2008,"2008-10-29",52,41,"11/4/2008",6,11,52.9,45.7,7.2
2008,"2008-10-30",52,43,"11/4/2008",5,9,52.9,45.7,7.2
2008,"2008-10-30",48,41,"11/4/2008",5,7,52.9,45.7,7.2
2008,"2008-10-30",49,45,"11/4/2008",5,4,52.9,45.7,7.2
2008,"2008-10-30",50,43,"11/4/2008",5,7,52.9,45.7,7.2
2008,"2008-10-31",51,44,"11/4/2008",4,7,52.9,45.7,7.2
2008,"2008-10-31",48,43,"11/4/2008",4,5,52.9,45.7,7.2
2008,"2008-10-31",51,46,"11/4/2008",4,5,52.9,45.7,7.2
2008,"2008-11-01",53,46,"11/4/2008",3,7,52.9,45.7,7.2
2008,"2008-11-01",51,45,"11/4/2008",3,6,52.9,45.7,7.2
2008,"2008-11-01",53,46,"11/4/2008",3,7,52.9,45.7,7.2
2008,"2008-11-01",52,46,"11/4/2008",3,6,52.9,45.7,7.2
2008,"2008-11-02",53,44,"11/4/2008",2,9,52.9,45.7,7.2
2008,"2008-11-02",53,44,"11/4/2008",2,9,52.9,45.7,7.2
2008,"2008-11-02",50,43,"11/4/2008",2,7,52.9,45.7,7.2
2008,"2008-11-02",50,45,"11/4/2008",2,5,52.9,45.7,7.2
2008,"2008-11-02",51,42,"11/4/2008",2,9,52.9,45.7,7.2
2008,"2008-11-02",51,43,"11/4/2008",2,8,52.9,45.7,7.2
2008,"2008-11-02",55,44,"11/4/2008",2,11,52.9,45.7,7.2
2008,"2008-11-02",51,44,"11/4/2008",2,7,52.9,45.7,7.2
2008,"2008-11-03",51,46,"11/4/2008",1,5,52.9,45.7,7.2
2008,"2008-11-03",52,43,"11/4/2008",1,9,52.9,45.7,7.2
2008,"2008-11-03",53,45,"11/4/2008",1,8,52.9,45.7,7.2
2008,"2008-11-03",54,43,"11/4/2008",1,11,52.9,45.7,7.2
2008,"2008-11-03",49,44,"11/4/2008",1,5,52.9,45.7,7.2
2008,"2008-11-03",52,44,"11/4/2008",1,8,52.9,45.7,7.2
2008,"2008-11-03",52,46,"11/4/2008",1,6,52.9,45.7,7.2
2008,"2008-11-03",52,44,"11/4/2008",1,8,52.9,45.7,7.2
2012,"2011-10-31",47,42,"11/6/2012",372,5,51.1,47.2,3.9
2012,"2011-11-01",47,39,"11/6/2012",371,8,51.1,47.2,3.9
2012,"2011-11-02",42,41,"11/6/2012",370,1,51.1,47.2,3.9
2012,"2011-11-03",43,44,"11/6/2012",369,-1,51.1,47.2,3.9
2012,"2011-11-03",46,45,"11/6/2012",369,1,51.1,47.2,3.9
2012,"2011-11-05",49,43,"11/6/2012",367,6,51.1,47.2,3.9
2012,"2011-11-08",46,42,"11/6/2012",364,4,51.1,47.2,3.9
2012,"2011-11-09",49,43,"11/6/2012",363,6,51.1,47.2,3.9
2012,"2011-11-10",43,42,"11/6/2012",362,1,51.1,47.2,3.9
2012,"2011-11-10",48,44,"11/6/2012",362,4,51.1,47.2,3.9
2012,"2011-11-13",47,51,"11/6/2012",359,-4,51.1,47.2,3.9
2012,"2011-11-13",46,43,"11/6/2012",359,3,51.1,47.2,3.9
2012,"2011-11-14",49,47,"11/6/2012",358,2,51.1,47.2,3.9
2012,"2011-11-15",46,44,"11/6/2012",357,2,51.1,47.2,3.9
2012,"2011-11-15",42,44,"11/6/2012",357,-2,51.1,47.2,3.9
2012,"2011-11-15",46,41,"11/6/2012",357,5,51.1,47.2,3.9
2012,"2011-11-17",42,44,"11/6/2012",355,-2,51.1,47.2,3.9
2012,"2011-11-20",45,44,"11/6/2012",352,1,51.1,47.2,3.9
2012,"2011-11-22",44,38,"11/6/2012",350,6,51.1,47.2,3.9
2012,"2011-11-22",37,53,"11/6/2012",350,-16,51.1,47.2,3.9
2012,"2011-11-22",46,43,"11/6/2012",350,3,51.1,47.2,3.9
2012,"2011-11-29",46,42,"11/6/2012",343,4,51.1,47.2,3.9
2012,"2011-12-01",42,40,"11/6/2012",341,2,51.1,47.2,3.9
2012,"2011-12-05",46,42,"11/6/2012",337,4,51.1,47.2,3.9
2012,"2011-12-06",46,44,"11/6/2012",336,2,51.1,47.2,3.9
2012,"2011-12-07",44,42,"11/6/2012",335,2,51.1,47.2,3.9
2012,"2011-12-09",42,45,"11/6/2012",333,-3,51.1,47.2,3.9
2012,"2011-12-11",47,45,"11/6/2012",331,2,51.1,47.2,3.9
2012,"2011-12-12",47,46,"11/6/2012",330,1,51.1,47.2,3.9
2012,"2011-12-12",48,40,"11/6/2012",330,8,51.1,47.2,3.9
2012,"2011-12-13",46,43,"11/6/2012",329,3,51.1,47.2,3.9
2012,"2011-12-15",42,43,"11/6/2012",327,-1,51.1,47.2,3.9
2012,"2011-12-18",52,45,"11/6/2012",324,7,51.1,47.2,3.9
2012,"2011-12-18",45,47,"11/6/2012",324,-2,51.1,47.2,3.9
2012,"2011-12-18",50,48,"11/6/2012",324,2,51.1,47.2,3.9
2012,"2011-12-18",47,47,"11/6/2012",324,0,51.1,47.2,3.9
2012,"2011-12-20",47,40,"11/6/2012",322,7,51.1,47.2,3.9
2012,"2011-12-21",44,41,"11/6/2012",321,3,51.1,47.2,3.9
2012,"2011-12-28",39,45,"11/6/2012",314,-6,51.1,47.2,3.9
2012,"2012-01-03",49,40,"11/6/2012",308,9,51.1,47.2,3.9
2012,"2012-01-04",42,42,"11/6/2012",307,0,51.1,47.2,3.9
2012,"2012-01-08",45,47,"11/6/2012",303,-2,51.1,47.2,3.9
2012,"2012-01-09",48,43,"11/6/2012",302,5,51.1,47.2,3.9
2012,"2012-01-10",44,41,"11/6/2012",301,3,51.1,47.2,3.9
2012,"2012-01-10",44,44,"11/6/2012",301,0,51.1,47.2,3.9
2012,"2012-01-11",47,46,"11/6/2012",300,1,51.1,47.2,3.9
2012,"2012-01-12",47,48,"11/6/2012",299,-1,51.1,47.2,3.9
2012,"2012-01-14",46,45,"11/6/2012",297,1,51.1,47.2,3.9
2012,"2012-01-15",46,48,"11/6/2012",296,-2,51.1,47.2,3.9
2012,"2012-01-16",49,44,"11/6/2012",295,5,51.1,47.2,3.9
2012,"2012-01-16",50,45,"11/6/2012",295,5,51.1,47.2,3.9
2012,"2012-01-17",45,45,"11/6/2012",294,0,51.1,47.2,3.9
2012,"2012-01-22",45,43,"11/6/2012",289,2,51.1,47.2,3.9
2012,"2012-01-24",49,43,"11/6/2012",287,6,51.1,47.2,3.9
2012,"2012-01-24",47,41,"11/6/2012",287,6,51.1,47.2,3.9
2012,"2012-01-25",46,43,"11/6/2012",286,3,51.1,47.2,3.9
2012,"2012-01-28",48,48,"11/6/2012",283,0,51.1,47.2,3.9
2012,"2012-01-28",45,43,"11/6/2012",283,2,51.1,47.2,3.9
2012,"2012-01-29",46,42,"11/6/2012",282,4,51.1,47.2,3.9
2012,"2012-01-31",47,43,"11/6/2012",280,4,51.1,47.2,3.9
2012,"2012-01-31",49,40,"11/6/2012",280,9,51.1,47.2,3.9
2012,"2012-02-03",46,44,"11/6/2012",277,2,51.1,47.2,3.9
2012,"2012-02-04",51,45,"11/6/2012",276,6,51.1,47.2,3.9
2012,"2012-02-06",48,42,"11/6/2012",274,6,51.1,47.2,3.9
2012,"2012-02-06",48,42,"11/6/2012",274,6,51.1,47.2,3.9
2012,"2012-02-07",51,39,"11/6/2012",273,12,51.1,47.2,3.9
2012,"2012-02-09",50,40,"11/6/2012",271,10,51.1,47.2,3.9
2012,"2012-02-09",47,42,"11/6/2012",271,5,51.1,47.2,3.9
2012,"2012-02-12",48,42,"11/6/2012",268,6,51.1,47.2,3.9
2012,"2012-02-12",49,42,"11/6/2012",268,7,51.1,47.2,3.9
2012,"2012-02-12",52,44,"11/6/2012",268,8,51.1,47.2,3.9
2012,"2012-02-12",45,41,"11/6/2012",268,4,51.1,47.2,3.9
2012,"2012-02-13",51,46,"11/6/2012",267,5,51.1,47.2,3.9
2012,"2012-02-13",48,42,"11/6/2012",267,6,51.1,47.2,3.9
2012,"2012-02-14",49,45,"11/6/2012",266,4,51.1,47.2,3.9
2012,"2012-02-14",49,42,"11/6/2012",266,7,51.1,47.2,3.9
2012,"2012-02-15",47,43,"11/6/2012",265,4,51.1,47.2,3.9
2012,"2012-02-18",47,43,"11/6/2012",262,4,51.1,47.2,3.9
2012,"2012-02-19",46,50,"11/6/2012",261,-4,51.1,47.2,3.9
2012,"2012-02-20",51,43,"11/6/2012",260,8,51.1,47.2,3.9
2012,"2012-02-20",46,44,"11/6/2012",260,2,51.1,47.2,3.9
2012,"2012-02-21",47,41,"11/6/2012",259,6,51.1,47.2,3.9
2012,"2012-02-21",49,41,"11/6/2012",259,8,51.1,47.2,3.9
2012,"2012-02-22",53,43,"11/6/2012",258,10,51.1,47.2,3.9
2012,"2012-02-24",46,43,"11/6/2012",256,3,51.1,47.2,3.9
2012,"2012-02-27",44,44,"11/6/2012",253,0,51.1,47.2,3.9
2012,"2012-02-28",49,40,"11/6/2012",252,9,51.1,47.2,3.9
2012,"2012-03-01",48,42,"11/6/2012",250,6,51.1,47.2,3.9
2012,"2012-03-03",50,44,"11/6/2012",248,6,51.1,47.2,3.9
2012,"2012-03-04",45,43,"11/6/2012",247,2,51.1,47.2,3.9
2012,"2012-03-06",49,41,"11/6/2012",245,8,51.1,47.2,3.9
2012,"2012-03-07",48,44,"11/6/2012",244,4,51.1,47.2,3.9
2012,"2012-03-10",42,48,"11/6/2012",241,-6,51.1,47.2,3.9
2012,"2012-03-10",47,49,"11/6/2012",241,-2,51.1,47.2,3.9
2012,"2012-03-11",47,47,"11/6/2012",240,0,51.1,47.2,3.9
2012,"2012-03-11",52,41,"11/6/2012",240,11,51.1,47.2,3.9
2012,"2012-03-11",47,44,"11/6/2012",240,3,51.1,47.2,3.9
2012,"2012-03-11",54,42,"11/6/2012",240,12,51.1,47.2,3.9
2012,"2012-03-12",46,42,"11/6/2012",239,4,51.1,47.2,3.9
2012,"2012-03-13",44,46,"11/6/2012",238,-2,51.1,47.2,3.9
2012,"2012-03-13",48,44,"11/6/2012",238,4,51.1,47.2,3.9
2012,"2012-03-16",49,43,"11/6/2012",235,6,51.1,47.2,3.9
2012,"2012-03-17",48,44,"11/6/2012",234,4,51.1,47.2,3.9
2012,"2012-03-19",46,45,"11/6/2012",232,1,51.1,47.2,3.9
2012,"2012-03-20",49,42,"11/6/2012",231,7,51.1,47.2,3.9
2012,"2012-03-20",46,40,"11/6/2012",231,6,51.1,47.2,3.9
2012,"2012-03-22",46,44,"11/6/2012",229,2,51.1,47.2,3.9
2012,"2012-03-22",45,45,"11/6/2012",229,0,51.1,47.2,3.9
2012,"2012-03-25",54,43,"11/6/2012",226,11,51.1,47.2,3.9
2012,"2012-03-25",46,43,"11/6/2012",226,3,51.1,47.2,3.9
2012,"2012-03-25",47,37,"11/6/2012",226,10,51.1,47.2,3.9
2012,"2012-03-26",49,45,"11/6/2012",225,4,51.1,47.2,3.9
2012,"2012-03-27",46,43,"11/6/2012",224,3,51.1,47.2,3.9
2012,"2012-03-28",44,46,"11/6/2012",223,-2,51.1,47.2,3.9
2012,"2012-03-31",46,45,"11/6/2012",220,1,51.1,47.2,3.9
2012,"2012-04-03",44,47,"11/6/2012",217,-3,51.1,47.2,3.9
2012,"2012-04-03",47,44,"11/6/2012",217,3,51.1,47.2,3.9
2012,"2012-04-05",46,38,"11/6/2012",215,8,51.1,47.2,3.9
2012,"2012-04-06",47,44,"11/6/2012",214,3,51.1,47.2,3.9
2012,"2012-04-08",51,43,"11/6/2012",212,8,51.1,47.2,3.9
2012,"2012-04-09",45,45,"11/6/2012",211,0,51.1,47.2,3.9
2012,"2012-04-10",46,43,"11/6/2012",210,3,51.1,47.2,3.9
2012,"2012-04-11",44,46,"11/6/2012",209,-2,51.1,47.2,3.9
2012,"2012-04-12",44,48,"11/6/2012",208,-4,51.1,47.2,3.9
2012,"2012-04-15",52,43,"11/6/2012",205,9,51.1,47.2,3.9
2012,"2012-04-15",44,47,"11/6/2012",205,-3,51.1,47.2,3.9
2012,"2012-04-15",47,43,"11/6/2012",205,4,51.1,47.2,3.9
2012,"2012-04-15",50,44,"11/6/2012",205,6,51.1,47.2,3.9
2012,"2012-04-15",49,46,"11/6/2012",205,3,51.1,47.2,3.9
2012,"2012-04-15",49,45,"11/6/2012",205,4,51.1,47.2,3.9
2012,"2012-04-16",49,42,"11/6/2012",204,7,51.1,47.2,3.9
2012,"2012-04-17",49,43,"11/6/2012",203,6,51.1,47.2,3.9
2012,"2012-04-17",46,46,"11/6/2012",203,0,51.1,47.2,3.9
2012,"2012-04-17",44,48,"11/6/2012",203,-4,51.1,47.2,3.9
2012,"2012-04-17",46,42,"11/6/2012",203,4,51.1,47.2,3.9
2012,"2012-04-18",45,46,"11/6/2012",202,-1,51.1,47.2,3.9
2012,"2012-04-21",45,46,"11/6/2012",199,-1,51.1,47.2,3.9
2012,"2012-04-22",49,44,"11/6/2012",198,5,51.1,47.2,3.9
2012,"2012-04-22",47,44,"11/6/2012",198,3,51.1,47.2,3.9
2012,"2012-04-23",46,47,"11/6/2012",197,-1,51.1,47.2,3.9
2012,"2012-04-24",49,43,"11/6/2012",196,6,51.1,47.2,3.9
2012,"2012-04-24",44,49,"11/6/2012",196,-5,51.1,47.2,3.9
2012,"2012-04-24",46,46,"11/6/2012",196,0,51.1,47.2,3.9
2012,"2012-04-27",47,45,"11/6/2012",193,2,51.1,47.2,3.9
2012,"2012-04-28",47,46,"11/6/2012",192,1,51.1,47.2,3.9
2012,"2012-04-29",49,44,"11/6/2012",191,5,51.1,47.2,3.9
2012,"2012-04-30",46,46,"11/6/2012",190,0,51.1,47.2,3.9
2012,"2012-04-30",48,43,"11/6/2012",190,5,51.1,47.2,3.9
2012,"2012-05-01",47,47,"11/6/2012",189,0,51.1,47.2,3.9
2012,"2012-05-02",49,42,"11/6/2012",188,7,51.1,47.2,3.9
2012,"2012-05-03",47,45,"11/6/2012",187,2,51.1,47.2,3.9
2012,"2012-05-03",45,45,"11/6/2012",187,0,51.1,47.2,3.9
2012,"2012-05-03",47,48,"11/6/2012",187,-1,51.1,47.2,3.9
2012,"2012-05-04",46,43,"11/6/2012",186,3,51.1,47.2,3.9
2012,"2012-05-06",45,47,"11/6/2012",184,-2,51.1,47.2,3.9
2012,"2012-05-06",48,45,"11/6/2012",184,3,51.1,47.2,3.9
2012,"2012-05-07",44,43,"11/6/2012",183,1,51.1,47.2,3.9
2012,"2012-05-07",50,42,"11/6/2012",183,8,51.1,47.2,3.9
2012,"2012-05-07",49,42,"11/6/2012",183,7,51.1,47.2,3.9
2012,"2012-05-08",46,49,"11/6/2012",182,-3,51.1,47.2,3.9
2012,"2012-05-09",45,49,"11/6/2012",181,-4,51.1,47.2,3.9
2012,"2012-05-10",45,46,"11/6/2012",180,-1,51.1,47.2,3.9
2012,"2012-05-12",43,44,"11/6/2012",178,-1,51.1,47.2,3.9
2012,"2012-05-12",44,48,"11/6/2012",178,-4,51.1,47.2,3.9
2012,"2012-05-13",48,46,"11/6/2012",177,2,51.1,47.2,3.9
2012,"2012-05-14",42,46,"11/6/2012",176,-4,51.1,47.2,3.9
2012,"2012-05-14",44,47,"11/6/2012",176,-3,51.1,47.2,3.9
2012,"2012-05-15",46,39,"11/6/2012",175,7,51.1,47.2,3.9
2012,"2012-05-16",45,46,"11/6/2012",174,-1,51.1,47.2,3.9
2012,"2012-05-16",43,40,"11/6/2012",174,3,51.1,47.2,3.9
2012,"2012-05-17",45,46,"11/6/2012",173,-1,51.1,47.2,3.9
2012,"2012-05-19",46,44,"11/6/2012",171,2,51.1,47.2,3.9
2012,"2012-05-20",47,46,"11/6/2012",170,1,51.1,47.2,3.9
2012,"2012-05-20",49,46,"11/6/2012",170,3,51.1,47.2,3.9
2012,"2012-05-20",47,43,"11/6/2012",170,4,51.1,47.2,3.9
2012,"2012-05-21",46,42,"11/6/2012",169,4,51.1,47.2,3.9
2012,"2012-05-22",46,45,"11/6/2012",168,1,51.1,47.2,3.9
2012,"2012-05-24",47,46,"11/6/2012",166,1,51.1,47.2,3.9
2012,"2012-05-25",44,45,"11/6/2012",165,-1,51.1,47.2,3.9
2012,"2012-05-28",46,45,"11/6/2012",162,1,51.1,47.2,3.9
2012,"2012-05-28",46,43,"11/6/2012",162,3,51.1,47.2,3.9
2012,"2012-05-31",49,46,"11/6/2012",159,3,51.1,47.2,3.9
2012,"2012-05-31",45,46,"11/6/2012",159,-1,51.1,47.2,3.9
2012,"2012-06-01",46,45,"11/6/2012",158,1,51.1,47.2,3.9
2012,"2012-06-03",44,47,"11/6/2012",156,-3,51.1,47.2,3.9
2012,"2012-06-03",50,42,"11/6/2012",156,8,51.1,47.2,3.9
2012,"2012-06-03",49,42,"11/6/2012",156,7,51.1,47.2,3.9
2012,"2012-06-04",47,42,"11/6/2012",155,5,51.1,47.2,3.9
2012,"2012-06-05",43,43,"11/6/2012",154,0,51.1,47.2,3.9
2012,"2012-06-06",47,46,"11/6/2012",153,1,51.1,47.2,3.9
2012,"2012-06-06",46,46,"11/6/2012",153,0,51.1,47.2,3.9
2012,"2012-06-07",47,46,"11/6/2012",152,1,51.1,47.2,3.9
2012,"2012-06-08",46,45,"11/6/2012",151,1,51.1,47.2,3.9
2012,"2012-06-08",46,42,"11/6/2012",151,4,51.1,47.2,3.9
2012,"2012-06-09",45,46,"11/6/2012",150,-1,51.1,47.2,3.9
2012,"2012-06-10",50,42,"11/6/2012",149,8,51.1,47.2,3.9
2012,"2012-06-11",44,42,"11/6/2012",148,2,51.1,47.2,3.9
2012,"2012-06-11",45,44,"11/6/2012",148,1,51.1,47.2,3.9
2012,"2012-06-12",44,48,"11/6/2012",147,-4,51.1,47.2,3.9
2012,"2012-06-15",45,47,"11/6/2012",144,-2,51.1,47.2,3.9
2012,"2012-06-15",45,46,"11/6/2012",144,-1,51.1,47.2,3.9
2012,"2012-06-17",49,45,"11/6/2012",142,4,51.1,47.2,3.9
2012,"2012-06-17",50,46,"11/6/2012",142,4,51.1,47.2,3.9
2012,"2012-06-18",44,48,"11/6/2012",141,-4,51.1,47.2,3.9
2012,"2012-06-18",44,44,"11/6/2012",141,0,51.1,47.2,3.9
2012,"2012-06-18",53,40,"11/6/2012",141,13,51.1,47.2,3.9
2012,"2012-06-18",47,44,"11/6/2012",141,3,51.1,47.2,3.9
2012,"2012-06-21",43,48,"11/6/2012",138,-5,51.1,47.2,3.9
2012,"2012-06-22",46,46,"11/6/2012",137,0,51.1,47.2,3.9
2012,"2012-06-24",45,47,"11/6/2012",135,-2,51.1,47.2,3.9
2012,"2012-06-24",48,45,"11/6/2012",135,3,51.1,47.2,3.9
2012,"2012-06-24",47,44,"11/6/2012",135,3,51.1,47.2,3.9
2012,"2012-06-25",45,44,"11/6/2012",134,1,51.1,47.2,3.9
2012,"2012-06-26",45,40,"11/6/2012",133,5,51.1,47.2,3.9
2012,"2012-06-27",45,45,"11/6/2012",132,0,51.1,47.2,3.9
2012,"2012-06-27",49,46,"11/6/2012",132,3,51.1,47.2,3.9
2012,"2012-06-28",47,44,"11/6/2012",131,3,51.1,47.2,3.9
2012,"2012-06-29",47,44,"11/6/2012",130,3,51.1,47.2,3.9
2012,"2012-06-30",45,45,"11/6/2012",129,0,51.1,47.2,3.9
2012,"2012-07-01",49,46,"11/6/2012",128,3,51.1,47.2,3.9
2012,"2012-07-01",48,45,"11/6/2012",128,3,51.1,47.2,3.9
2012,"2012-07-02",47,43,"11/6/2012",127,4,51.1,47.2,3.9
2012,"2012-07-05",44,46,"11/6/2012",124,-2,51.1,47.2,3.9
2012,"2012-07-05",43,42,"11/6/2012",124,1,51.1,47.2,3.9
2012,"2012-07-07",47,45,"11/6/2012",122,2,51.1,47.2,3.9
2012,"2012-07-08",42,43,"11/6/2012",121,-1,51.1,47.2,3.9
2012,"2012-07-08",45,46,"11/6/2012",121,-1,51.1,47.2,3.9
2012,"2012-07-08",47,47,"11/6/2012",121,0,51.1,47.2,3.9
2012,"2012-07-08",46,43,"11/6/2012",121,3,51.1,47.2,3.9
2012,"2012-07-09",43,44,"11/6/2012",120,-1,51.1,47.2,3.9
2012,"2012-07-09",49,43,"11/6/2012",120,6,51.1,47.2,3.9
2012,"2012-07-09",50,43,"11/6/2012",120,7,51.1,47.2,3.9
2012,"2012-07-11",48,46,"11/6/2012",118,2,51.1,47.2,3.9
2012,"2012-07-11",45,46,"11/6/2012",118,-1,51.1,47.2,3.9
2012,"2012-07-12",47,45,"11/6/2012",117,2,51.1,47.2,3.9
2012,"2012-07-14",45,45,"11/6/2012",115,0,51.1,47.2,3.9
2012,"2012-07-14",47,45,"11/6/2012",115,2,51.1,47.2,3.9
2012,"2012-07-15",48,46,"11/6/2012",114,2,51.1,47.2,3.9
2012,"2012-07-16",47,44,"11/6/2012",113,3,51.1,47.2,3.9
2012,"2012-07-16",46,47,"11/6/2012",113,-1,51.1,47.2,3.9
2012,"2012-07-17",46,47,"11/6/2012",112,-1,51.1,47.2,3.9
2012,"2012-07-17",45,41,"11/6/2012",112,4,51.1,47.2,3.9
2012,"2012-07-20",46,46,"11/6/2012",109,0,51.1,47.2,3.9
2012,"2012-07-21",46,45,"11/6/2012",108,1,51.1,47.2,3.9
2012,"2012-07-22",46,46,"11/6/2012",107,0,51.1,47.2,3.9
2012,"2012-07-22",49,43,"11/6/2012",107,6,51.1,47.2,3.9
2012,"2012-07-23",44,45,"11/6/2012",106,-1,51.1,47.2,3.9
2012,"2012-07-23",44,45,"11/6/2012",106,-1,51.1,47.2,3.9
2012,"2012-07-25",50,46,"11/6/2012",104,4,51.1,47.2,3.9
2012,"2012-07-26",44,49,"11/6/2012",103,-5,51.1,47.2,3.9
2012,"2012-07-26",51,41,"11/6/2012",103,10,51.1,47.2,3.9
2012,"2012-07-29",44,47,"11/6/2012",100,-3,51.1,47.2,3.9
2012,"2012-07-29",48,47,"11/6/2012",100,1,51.1,47.2,3.9
2012,"2012-07-29",46,46,"11/6/2012",100,0,51.1,47.2,3.9
2012,"2012-07-30",44,46,"11/6/2012",99,-2,51.1,47.2,3.9
2012,"2012-08-01",44,46,"11/6/2012",97,-2,51.1,47.2,3.9
2012,"2012-08-04",45,47,"11/6/2012",94,-2,51.1,47.2,3.9
2012,"2012-08-05",48,46,"11/6/2012",93,2,51.1,47.2,3.9
2012,"2012-08-05",46,45,"11/6/2012",93,1,51.1,47.2,3.9
2012,"2012-08-05",50,43,"11/6/2012",93,7,51.1,47.2,3.9
2012,"2012-08-06",46,45,"11/6/2012",92,1,51.1,47.2,3.9
2012,"2012-08-06",49,42,"11/6/2012",92,7,51.1,47.2,3.9
2012,"2012-08-07",45,45,"11/6/2012",91,0,51.1,47.2,3.9
2012,"2012-08-07",49,40,"11/6/2012",91,9,51.1,47.2,3.9
2012,"2012-08-08",52,45,"11/6/2012",90,7,51.1,47.2,3.9
2012,"2012-08-09",48,46,"11/6/2012",89,2,51.1,47.2,3.9
2012,"2012-08-10",44,46,"11/6/2012",88,-2,51.1,47.2,3.9
2012,"2012-08-10",46,39,"11/6/2012",88,7,51.1,47.2,3.9
2012,"2012-08-12",47,45,"11/6/2012",86,2,51.1,47.2,3.9
2012,"2012-08-12",46,46,"11/6/2012",86,0,51.1,47.2,3.9
2012,"2012-08-13",44,47,"11/6/2012",85,-3,51.1,47.2,3.9
2012,"2012-08-13",47,44,"11/6/2012",85,3,51.1,47.2,3.9
2012,"2012-08-16",46,45,"11/6/2012",82,1,51.1,47.2,3.9
2012,"2012-08-19",43,44,"11/6/2012",79,-1,51.1,47.2,3.9
2012,"2012-08-19",49,45,"11/6/2012",79,4,51.1,47.2,3.9
2012,"2012-08-19",46,45,"11/6/2012",79,1,51.1,47.2,3.9
2012,"2012-08-19",45,47,"11/6/2012",79,-2,51.1,47.2,3.9
2012,"2012-08-19",48,46,"11/6/2012",79,2,51.1,47.2,3.9
2012,"2012-08-20",45,45,"11/6/2012",78,0,51.1,47.2,3.9
2012,"2012-08-20",48,44,"11/6/2012",78,4,51.1,47.2,3.9
2012,"2012-08-20",47,46,"11/6/2012",78,1,51.1,47.2,3.9
2012,"2012-08-21",44,45,"11/6/2012",77,-1,51.1,47.2,3.9
2012,"2012-08-22",45,45,"11/6/2012",76,0,51.1,47.2,3.9
2012,"2012-08-22",46,45,"11/6/2012",76,1,51.1,47.2,3.9
2012,"2012-08-23",49,47,"11/6/2012",75,2,51.1,47.2,3.9
2012,"2012-08-23",47,46,"11/6/2012",75,1,51.1,47.2,3.9
2012,"2012-08-25",47,45,"11/6/2012",73,2,51.1,47.2,3.9
2012,"2012-08-25",46,47,"11/6/2012",73,-1,51.1,47.2,3.9
2012,"2012-08-26",50,44,"11/6/2012",72,6,51.1,47.2,3.9
2012,"2012-08-26",46,45,"11/6/2012",72,1,51.1,47.2,3.9
2012,"2012-08-26",46,47,"11/6/2012",72,-1,51.1,47.2,3.9
2012,"2012-08-27",46,47,"11/6/2012",71,-1,51.1,47.2,3.9
2012,"2012-08-27",49,47,"11/6/2012",71,2,51.1,47.2,3.9
2012,"2012-08-28",46,45,"11/6/2012",70,1,51.1,47.2,3.9
2012,"2012-08-28",45,43,"11/6/2012",70,2,51.1,47.2,3.9
2012,"2012-08-31",44,47,"11/6/2012",67,-3,51.1,47.2,3.9
2012,"2012-09-02",45,45,"11/6/2012",65,0,51.1,47.2,3.9
2012,"2012-09-02",47,46,"11/6/2012",65,1,51.1,47.2,3.9
2012,"2012-09-03",45,47,"11/6/2012",64,-2,51.1,47.2,3.9
2012,"2012-09-03",47,46,"11/6/2012",64,1,51.1,47.2,3.9
2012,"2012-09-03",48,48,"11/6/2012",64,0,51.1,47.2,3.9
2012,"2012-09-06",46,49,"11/6/2012",61,-3,51.1,47.2,3.9
2012,"2012-09-06",45,46,"11/6/2012",61,-1,51.1,47.2,3.9
2012,"2012-09-08",47,43,"11/6/2012",59,4,51.1,47.2,3.9
2012,"2012-09-09",52,46,"11/6/2012",58,6,51.1,47.2,3.9
2012,"2012-09-09",50,44,"11/6/2012",58,6,51.1,47.2,3.9
2012,"2012-09-09",50,45,"11/6/2012",58,5,51.1,47.2,3.9
2012,"2012-09-09",49,48,"11/6/2012",58,1,51.1,47.2,3.9
2012,"2012-09-09",46,44,"11/6/2012",58,2,51.1,47.2,3.9
2012,"2012-09-09",49,44,"11/6/2012",58,5,51.1,47.2,3.9
2012,"2012-09-10",49,45,"11/6/2012",57,4,51.1,47.2,3.9
2012,"2012-09-10",48,45,"11/6/2012",57,3,51.1,47.2,3.9
2012,"2012-09-10",50,46,"11/6/2012",57,4,51.1,47.2,3.9
2012,"2012-09-11",48,43,"11/6/2012",56,5,51.1,47.2,3.9
2012,"2012-09-12",48,42,"11/6/2012",55,6,51.1,47.2,3.9
2012,"2012-09-12",46,47,"11/6/2012",55,-1,51.1,47.2,3.9
2012,"2012-09-12",49,46,"11/6/2012",55,3,51.1,47.2,3.9
2012,"2012-09-12",50,45,"11/6/2012",55,5,51.1,47.2,3.9
2012,"2012-09-13",48,41,"11/6/2012",54,7,51.1,47.2,3.9
2012,"2012-09-14",49,45,"11/6/2012",53,4,51.1,47.2,3.9
2012,"2012-09-15",46,47,"11/6/2012",52,-1,51.1,47.2,3.9
2012,"2012-09-16",48,45,"11/6/2012",51,3,51.1,47.2,3.9
2012,"2012-09-16",50,46,"11/6/2012",51,4,51.1,47.2,3.9
2012,"2012-09-16",50,45,"11/6/2012",51,5,51.1,47.2,3.9
2012,"2012-09-16",51,43,"11/6/2012",51,8,51.1,47.2,3.9
2012,"2012-09-16",48,45,"11/6/2012",51,3,51.1,47.2,3.9
2012,"2012-09-17",49,44,"11/6/2012",50,5,51.1,47.2,3.9
2012,"2012-09-17",47,46,"11/6/2012",50,1,51.1,47.2,3.9
2012,"2012-09-17",52,45,"11/6/2012",50,7,51.1,47.2,3.9
2012,"2012-09-18",46,47,"11/6/2012",49,-1,51.1,47.2,3.9
2012,"2012-09-18",46,43,"11/6/2012",49,3,51.1,47.2,3.9
2012,"2012-09-19",50,43,"11/6/2012",48,7,51.1,47.2,3.9
2012,"2012-09-20",48,46,"11/6/2012",47,2,51.1,47.2,3.9
2012,"2012-09-20",49,47,"11/6/2012",47,2,51.1,47.2,3.9
2012,"2012-09-20",50,47,"11/6/2012",47,3,51.1,47.2,3.9
2012,"2012-09-21",46,46,"11/6/2012",46,0,51.1,47.2,3.9
2012,"2012-09-21",48,42,"11/6/2012",46,6,51.1,47.2,3.9
2012,"2012-09-22",49,41,"11/6/2012",45,8,51.1,47.2,3.9
2012,"2012-09-22",49,46,"11/6/2012",45,3,51.1,47.2,3.9
2012,"2012-09-23",50,45,"11/6/2012",44,5,51.1,47.2,3.9
2012,"2012-09-23",48,46,"11/6/2012",44,2,51.1,47.2,3.9
2012,"2012-09-24",47,46,"11/6/2012",43,1,51.1,47.2,3.9
2012,"2012-09-24",48,43,"11/6/2012",43,5,51.1,47.2,3.9
2012,"2012-09-24",49,43,"11/6/2012",43,6,51.1,47.2,3.9
2012,"2012-09-26",48,43,"11/6/2012",41,5,51.1,47.2,3.9
2012,"2012-09-27",47,46,"11/6/2012",40,1,51.1,47.2,3.9
2012,"2012-09-27",46,43,"11/6/2012",40,3,51.1,47.2,3.9
2012,"2012-09-27",49,47,"11/6/2012",40,2,51.1,47.2,3.9
2012,"2012-09-28",47,42,"11/6/2012",39,5,51.1,47.2,3.9
2012,"2012-09-29",50,41,"11/6/2012",38,9,51.1,47.2,3.9
2012,"2012-09-29",49,47,"11/6/2012",38,2,51.1,47.2,3.9
2012,"2012-09-29",49,46,"11/6/2012",38,3,51.1,47.2,3.9
2012,"2012-09-30",50,47,"11/6/2012",37,3,51.1,47.2,3.9
2012,"2012-09-30",48,45,"11/6/2012",37,3,51.1,47.2,3.9
2012,"2012-09-30",49,46,"11/6/2012",37,3,51.1,47.2,3.9
2012,"2012-09-30",47,47,"11/6/2012",37,0,51.1,47.2,3.9
2012,"2012-09-30",49,45,"11/6/2012",37,4,51.1,47.2,3.9
2012,"2012-09-30",49,46,"11/6/2012",37,3,51.1,47.2,3.9
2012,"2012-09-30",51,44,"11/6/2012",37,7,51.1,47.2,3.9
2012,"2012-09-30",49,45,"11/6/2012",37,4,51.1,47.2,3.9
2012,"2012-09-30",49,45,"11/6/2012",37,4,51.1,47.2,3.9
2012,"2012-10-01",49,44,"11/6/2012",36,5,51.1,47.2,3.9
2012,"2012-10-02",49,45,"11/6/2012",35,4,51.1,47.2,3.9
2012,"2012-10-02",49,45,"11/6/2012",35,4,51.1,47.2,3.9
2012,"2012-10-03",49,47,"11/6/2012",34,2,51.1,47.2,3.9
2012,"2012-10-04",46,47,"11/6/2012",33,-1,51.1,47.2,3.9
2012,"2012-10-04",49,48,"11/6/2012",33,1,51.1,47.2,3.9
2012,"2012-10-05",46,44,"11/6/2012",32,2,51.1,47.2,3.9
2012,"2012-10-06",47,49,"11/6/2012",31,-2,51.1,47.2,3.9
2012,"2012-10-07",45,45,"11/6/2012",30,0,51.1,47.2,3.9
2012,"2012-10-07",45,49,"11/6/2012",30,-4,51.1,47.2,3.9
2012,"2012-10-07",47,49,"11/6/2012",30,-2,51.1,47.2,3.9
2012,"2012-10-07",50,45,"11/6/2012",30,5,51.1,47.2,3.9
2012,"2012-10-08",49,46,"11/6/2012",29,3,51.1,47.2,3.9
2012,"2012-10-08",47,48,"11/6/2012",29,-1,51.1,47.2,3.9
2012,"2012-10-09",47,48,"11/6/2012",28,-1,51.1,47.2,3.9
2012,"2012-10-09",45,46,"11/6/2012",28,-1,51.1,47.2,3.9
2012,"2012-10-09",44,49,"11/6/2012",28,-5,51.1,47.2,3.9
2012,"2012-10-10",46,47,"11/6/2012",27,-1,51.1,47.2,3.9
2012,"2012-10-10",44,45,"11/6/2012",27,-1,51.1,47.2,3.9
2012,"2012-10-10",46,49,"11/6/2012",27,-3,51.1,47.2,3.9
2012,"2012-10-11",49,48,"11/6/2012",26,1,51.1,47.2,3.9
2012,"2012-10-12",48,49,"11/6/2012",25,-1,51.1,47.2,3.9
2012,"2012-10-13",47,44,"11/6/2012",24,3,51.1,47.2,3.9
2012,"2012-10-13",49,46,"11/6/2012",24,3,51.1,47.2,3.9
2012,"2012-10-14",46,50,"11/6/2012",23,-4,51.1,47.2,3.9
2012,"2012-10-14",47,48,"11/6/2012",23,-1,51.1,47.2,3.9
2012,"2012-10-14",47,49,"11/6/2012",23,-2,51.1,47.2,3.9
2012,"2012-10-15",47,49,"11/6/2012",22,-2,51.1,47.2,3.9
2012,"2012-10-15",47,46,"11/6/2012",22,1,51.1,47.2,3.9
2012,"2012-10-15",47,45,"11/6/2012",22,2,51.1,47.2,3.9
2012,"2012-10-15",47,46,"11/6/2012",22,1,51.1,47.2,3.9
2012,"2012-10-16",48,45,"11/6/2012",21,3,51.1,47.2,3.9
2012,"2012-10-18",44,46,"11/6/2012",19,-2,51.1,47.2,3.9
2012,"2012-10-18",48,48,"11/6/2012",19,0,51.1,47.2,3.9
2012,"2012-10-18",47,49,"11/6/2012",19,-2,51.1,47.2,3.9
2012,"2012-10-18",46,48,"11/6/2012",19,-2,51.1,47.2,3.9
2012,"2012-10-19",49,47,"11/6/2012",18,2,51.1,47.2,3.9
2012,"2012-10-20",50,47,"11/6/2012",17,3,51.1,47.2,3.9
2012,"2012-10-20",47,47,"11/6/2012",17,0,51.1,47.2,3.9
2012,"2012-10-20",48,46,"11/6/2012",17,2,51.1,47.2,3.9
2012,"2012-10-20",46,45,"11/6/2012",17,1,51.1,47.2,3.9
2012,"2012-10-21",47,49,"11/6/2012",16,-2,51.1,47.2,3.9
2012,"2012-10-21",47,49,"11/6/2012",16,-2,51.1,47.2,3.9
2012,"2012-10-21",49,46,"11/6/2012",16,3,51.1,47.2,3.9
2012,"2012-10-21",45,48,"11/6/2012",16,-3,51.1,47.2,3.9
2012,"2012-10-21",48,48,"11/6/2012",16,0,51.1,47.2,3.9
2012,"2012-10-21",47,43,"11/6/2012",16,4,51.1,47.2,3.9
2012,"2012-10-21",45,51,"11/6/2012",16,-6,51.1,47.2,3.9
2012,"2012-10-22",47,49,"11/6/2012",15,-2,51.1,47.2,3.9
2012,"2012-10-22",48,46,"11/6/2012",15,2,51.1,47.2,3.9
2012,"2012-10-23",48,49,"11/6/2012",14,-1,51.1,47.2,3.9
2012,"2012-10-23",45,47,"11/6/2012",14,-2,51.1,47.2,3.9
2012,"2012-10-24",47,50,"11/6/2012",13,-3,51.1,47.2,3.9
2012,"2012-10-25",47,48,"11/6/2012",12,-1,51.1,47.2,3.9
2012,"2012-10-25",48,48,"11/6/2012",12,0,51.1,47.2,3.9
2012,"2012-10-25",49,48,"11/6/2012",12,1,51.1,47.2,3.9
2012,"2012-10-25",48,48,"11/6/2012",12,0,51.1,47.2,3.9
2012,"2012-10-26",47,46,"11/6/2012",11,1,51.1,47.2,3.9
2012,"2012-10-27",47,50,"11/6/2012",10,-3,51.1,47.2,3.9
2012,"2012-10-27",48,49,"11/6/2012",10,-1,51.1,47.2,3.9
2012,"2012-10-27",45,44,"11/6/2012",10,1,51.1,47.2,3.9
2012,"2012-10-28",48,49,"11/6/2012",9,-1,51.1,47.2,3.9
2012,"2012-10-28",48,47,"11/6/2012",9,1,51.1,47.2,3.9
2012,"2012-10-28",48,48,"11/6/2012",9,0,51.1,47.2,3.9
2012,"2012-10-28",48,47,"11/6/2012",9,1,51.1,47.2,3.9
2012,"2012-10-28",50,45,"11/6/2012",9,5,51.1,47.2,3.9
2012,"2012-10-28",49,49,"11/6/2012",9,0,51.1,47.2,3.9
2012,"2012-10-28",47,47,"11/6/2012",9,0,51.1,47.2,3.9
2012,"2012-10-28",46,51,"11/6/2012",9,-5,51.1,47.2,3.9
2012,"2012-10-29",46,47,"11/6/2012",8,-1,51.1,47.2,3.9
2012,"2012-10-30",47,49,"11/6/2012",7,-2,51.1,47.2,3.9
2012,"2012-10-30",46,46,"11/6/2012",7,0,51.1,47.2,3.9
2012,"2012-10-30",46,43,"11/6/2012",7,3,51.1,47.2,3.9
2012,"2012-10-31",49,49,"11/6/2012",6,0,51.1,47.2,3.9
2012,"2012-10-31",49,48,"11/6/2012",6,1,51.1,47.2,3.9
2012,"2012-10-31",47,46,"11/6/2012",6,1,51.1,47.2,3.9
2012,"2012-11-01",47,46,"11/6/2012",5,1,51.1,47.2,3.9
2012,"2012-11-01",48,46,"11/6/2012",5,2,51.1,47.2,3.9
2012,"2012-11-01",49,48,"11/6/2012",5,1,51.1,47.2,3.9
2012,"2012-11-01",48,48,"11/6/2012",5,0,51.1,47.2,3.9
2012,"2012-11-01",48,48,"11/6/2012",5,0,51.1,47.2,3.9
2012,"2012-11-02",49,48,"11/6/2012",4,1,51.1,47.2,3.9
2012,"2012-11-02",48,48,"11/6/2012",4,0,51.1,47.2,3.9
2012,"2012-11-03",51,48,"11/6/2012",3,3,51.1,47.2,3.9
2012,"2012-11-03",48,47,"11/6/2012",3,1,51.1,47.2,3.9
2012,"2012-11-03",48,45,"11/6/2012",3,3,51.1,47.2,3.9
2012,"2012-11-03",49,47,"11/6/2012",3,2,51.1,47.2,3.9
2012,"2012-11-04",49,49,"11/6/2012",2,0,51.1,47.2,3.9
2012,"2012-11-04",49,49,"11/6/2012",2,0,51.1,47.2,3.9
2012,"2012-11-04",50,48,"11/6/2012",2,2,51.1,47.2,3.9
2012,"2012-11-04",48,49,"11/6/2012",2,-1,51.1,47.2,3.9
2012,"2012-11-04",49,45,"11/6/2012",2,4,51.1,47.2,3.9
2012,"2012-11-04",48,48,"11/6/2012",2,0,51.1,47.2,3.9
2012,"2012-11-04",50,48,"11/6/2012",2,2,51.1,47.2,3.9
2012,"2012-11-04",50,47,"11/6/2012",2,3,51.1,47.2,3.9
2012,"2012-11-05",47,47,"11/6/2012",1,0,51.1,47.2,3.9
2012,"2012-11-05",49,48,"11/6/2012",1,1,51.1,47.2,3.9
2012,"2012-11-05",48,48,"11/6/2012",1,0,51.1,47.2,3.9
2012,"2012-11-05",47,47,"11/6/2012",1,0,51.1,47.2,3.9
2012,"2012-11-05",48,49,"11/6/2012",1,-1,51.1,47.2,3.9
2012,"2012-11-05",50,49,"11/6/2012",1,1,51.1,47.2,3.9
2012,"2012-11-05",49,47,"11/6/2012",1,2,51.1,47.2,3.9
2012,"2012-11-05",48,46,"11/6/2012",1,2,51.1,47.2,3.9
2016,"2016-11-07",43,42,"11/8/2016",1,1,48.1,46,2.1
2016,"2016-11-07",49,45,"11/8/2016",1,4,48.1,46,2.1
2016,"2016-11-06",46,43,"11/8/2016",2,3,48.1,46,2.1
2016,"2016-11-06",49,46,"11/8/2016",2,3,48.1,46,2.1
2016,"2016-11-06",50,44,"11/8/2016",2,6,48.1,46,2.1
2016,"2016-11-06",48,44,"11/8/2016",2,4,48.1,46,2.1
2016,"2016-11-06",44,39,"11/8/2016",2,5,48.1,46,2.1
2016,"2016-11-06",47,43,"11/8/2016",2,4,48.1,46,2.1
2016,"2016-11-06",49,46,"11/8/2016",2,3,48.1,46,2.1
2016,"2016-11-06",51,44,"11/8/2016",2,7,48.1,46,2.1
2016,"2016-11-05",48,43,"11/8/2016",3,5,48.1,46,2.1
2016,"2016-11-03",46,44,"11/8/2016",5,2,48.1,46,2.1
2016,"2016-11-03",46,45,"11/8/2016",5,1,48.1,46,2.1
2016,"2016-11-03",45,44,"11/8/2016",5,1,48.1,46,2.1
2016,"2016-11-02",49,46,"11/8/2016",6,3,48.1,46,2.1
2016,"2016-11-01",48,45,"11/8/2016",7,3,48.1,46,2.1
2016,"2016-11-01",47,44,"11/8/2016",7,3,48.1,46,2.1
2016,"2016-10-31",50,50,"11/8/2016",8,0,48.1,46,2.1
2016,"2016-10-30",46,43,"11/8/2016",9,3,48.1,46,2.1
2016,"2016-10-30",52,47,"11/8/2016",9,5,48.1,46,2.1
2016,"2016-10-30",51,48,"11/8/2016",9,3,48.1,46,2.1
2016,"2016-10-30",49,48,"11/8/2016",9,1,48.1,46,2.1
2016,"2016-10-30",51,44,"11/8/2016",9,7,48.1,46,2.1
2016,"2016-10-29",49,47,"11/8/2016",10,2,48.1,46,2.1
2016,"2016-10-29",45,41,"11/8/2016",10,4,48.1,46,2.1
2016,"2016-10-26",49,46,"11/8/2016",13,3,48.1,46,2.1
2016,"2016-10-25",51,44,"11/8/2016",14,7,48.1,46,2.1
2016,"2016-10-25",49,44,"11/8/2016",14,5,48.1,46,2.1
2016,"2016-10-25",50,43,"11/8/2016",14,7,48.1,46,2.1
2016,"2016-10-24",47,37,"11/8/2016",15,10,48.1,46,2.1
2016,"2016-10-24",51,43,"11/8/2016",15,8,48.1,46,2.1
2016,"2016-10-24",53,41,"11/8/2016",15,12,48.1,46,2.1
2016,"2016-10-24",54,41,"11/8/2016",15,13,48.1,46,2.1
2016,"2016-10-24",49,39,"11/8/2016",15,10,48.1,46,2.1
2016,"2016-10-24",43,37,"11/8/2016",15,6,48.1,46,2.1
2016,"2016-10-23",51,45,"11/8/2016",16,6,48.1,46,2.1
2016,"2016-10-23",42,42,"11/8/2016",16,0,48.1,46,2.1
2016,"2016-10-23",50,44,"11/8/2016",16,6,48.1,46,2.1
2016,"2016-10-23",50,46,"11/8/2016",16,4,48.1,46,2.1
2016,"2016-10-20",46,40,"11/8/2016",19,6,48.1,46,2.1
2016,"2016-10-20",49,42,"11/8/2016",19,7,48.1,46,2.1
2016,"2016-10-18",50,44,"11/8/2016",21,6,48.1,46,2.1
2016,"2016-10-18",47,43,"11/8/2016",21,4,48.1,46,2.1
2016,"2016-10-17",49,42,"11/8/2016",22,7,48.1,46,2.1
2016,"2016-10-17",50,41,"11/8/2016",22,9,48.1,46,2.1
2016,"2016-10-17",43,39,"11/8/2016",22,4,48.1,46,2.1
2016,"2016-10-16",53,41,"11/8/2016",23,12,48.1,46,2.1
2016,"2016-10-16",51,40,"11/8/2016",23,11,48.1,46,2.1
2016,"2016-10-16",51,43,"11/8/2016",23,8,48.1,46,2.1
2016,"2016-10-16",50,46,"11/8/2016",23,4,48.1,46,2.1
2016,"2016-10-15",46,41,"11/8/2016",24,5,48.1,46,2.1
2016,"2016-10-13",51,41,"11/8/2016",26,10,48.1,46,2.1
2016,"2016-10-13",50,46,"11/8/2016",26,4,48.1,46,2.1
2016,"2016-10-12",49,41,"11/8/2016",27,8,48.1,46,2.1
2016,"2016-10-10",46,41,"11/8/2016",29,5,48.1,46,2.1
2016,"2016-10-10",50,40,"11/8/2016",29,10,48.1,46,2.1
2016,"2016-10-10",44,37,"11/8/2016",29,7,48.1,46,2.1
2016,"2016-10-10",53,44,"11/8/2016",29,9,48.1,46,2.1
2016,"2016-10-09",50,44,"11/8/2016",30,6,48.1,46,2.1
2016,"2016-10-09",51,44,"11/8/2016",30,7,48.1,46,2.1
2016,"2016-10-08",45,41,"11/8/2016",31,4,48.1,46,2.1
2016,"2016-10-08",48,43,"11/8/2016",31,5,48.1,46,2.1
2016,"2016-10-06",50,44,"11/8/2016",33,6,48.1,46,2.1
2016,"2016-10-06",48,44,"11/8/2016",33,4,48.1,46,2.1
2016,"2016-10-03",48,43,"11/8/2016",36,5,48.1,46,2.1
2016,"2016-10-03",44,37,"11/8/2016",36,7,48.1,46,2.1
2016,"2016-10-02",46,39,"11/8/2016",37,7,48.1,46,2.1
2016,"2016-10-02",50,40,"11/8/2016",37,10,48.1,46,2.1
2016,"2016-10-02",49,43,"11/8/2016",37,6,48.1,46,2.1
2016,"2016-10-02",51,45,"11/8/2016",37,6,48.1,46,2.1
2016,"2016-10-02",50,44,"11/8/2016",37,6,48.1,46,2.1
2016,"2016-10-02",47,49,"11/8/2016",37,-2,48.1,46,2.1
2016,"2016-09-29",49,44,"11/8/2016",40,5,48.1,46,2.1
2016,"2016-09-28",49,45,"11/8/2016",41,4,48.1,46,2.1
2016,"2016-09-28",42,38,"11/8/2016",41,4,48.1,46,2.1
2016,"2016-09-27",47,42,"11/8/2016",42,5,48.1,46,2.1
2016,"2016-09-27",45,41,"11/8/2016",42,4,48.1,46,2.1
2016,"2016-09-26",44,38,"11/8/2016",43,6,48.1,46,2.1
2016,"2016-09-25",49,46,"11/8/2016",44,3,48.1,46,2.1
2016,"2016-09-25",47,46,"11/8/2016",44,1,48.1,46,2.1
2016,"2016-09-25",51,44,"11/8/2016",44,7,48.1,46,2.1
2016,"2016-09-25",48,47,"11/8/2016",44,1,48.1,46,2.1
2016,"2016-09-24",48,44,"11/8/2016",45,4,48.1,46,2.1
2016,"2016-09-24",44,42,"11/8/2016",45,2,48.1,46,2.1
2016,"2016-09-24",46,46,"11/8/2016",45,0,48.1,46,2.1
2016,"2016-09-22",49,47,"11/8/2016",47,2,48.1,46,2.1
2016,"2016-09-20",47,44,"11/8/2016",49,3,48.1,46,2.1
2016,"2016-09-20",48,41,"11/8/2016",49,7,48.1,46,2.1
2016,"2016-09-19",48,41,"11/8/2016",50,7,48.1,46,2.1
2016,"2016-09-19",50,44,"11/8/2016",50,6,48.1,46,2.1
2016,"2016-09-19",39,39,"11/8/2016",50,0,48.1,46,2.1
2016,"2016-09-18",48,47,"11/8/2016",51,1,48.1,46,2.1
2016,"2016-09-18",50,45,"11/8/2016",51,5,48.1,46,2.1
2016,"2016-09-16",46,42,"11/8/2016",53,4,48.1,46,2.1
2016,"2016-09-14",45,46,"11/8/2016",55,-1,48.1,46,2.1
2016,"2016-09-13",46,44,"11/8/2016",56,2,48.1,46,2.1
2016,"2016-09-13",48,43,"11/8/2016",56,5,48.1,46,2.1
2016,"2016-09-12",40,39,"11/8/2016",57,1,48.1,46,2.1
2016,"2016-09-11",48,44,"11/8/2016",58,4,48.1,46,2.1
2016,"2016-09-11",46,49,"11/8/2016",58,-3,48.1,46,2.1
2016,"2016-09-08",44,43,"11/8/2016",61,1,48.1,46,2.1
2016,"2016-09-08",51,43,"11/8/2016",61,8,48.1,46,2.1
2016,"2016-09-05",40,38,"11/8/2016",64,2,48.1,46,2.1
2016,"2016-09-04",48,49,"11/8/2016",65,-1,48.1,46,2.1
2016,"2016-09-04",49,47,"11/8/2016",65,2,48.1,46,2.1
2016,"2016-09-04",48,42,"11/8/2016",65,6,48.1,46,2.1
2016,"2016-09-02",42,40,"11/8/2016",67,2,48.1,46,2.1
2016,"2016-09-01",44,43,"11/8/2016",68,1,48.1,46,2.1
2016,"2016-08-30",48,42,"11/8/2016",70,6,48.1,46,2.1
2016,"2016-08-29",40,39,"11/8/2016",71,1,48.1,46,2.1
2016,"2016-08-29",48,41,"11/8/2016",71,7,48.1,46,2.1
2016,"2016-08-28",48,43,"11/8/2016",72,5,48.1,46,2.1
2016,"2016-08-28",49,42,"11/8/2016",72,7,48.1,46,2.1
2016,"2016-08-28",50,47,"11/8/2016",72,3,48.1,46,2.1
2016,"2016-08-28",48,42,"11/8/2016",72,6,48.1,46,2.1
2016,"2016-08-26",43,40,"11/8/2016",74,3,48.1,46,2.1
2016,"2016-08-24",42,35,"11/8/2016",76,7,48.1,46,2.1
2016,"2016-08-24",51,41,"11/8/2016",76,10,48.1,46,2.1
2016,"2016-08-21",48,47,"11/8/2016",79,1,48.1,46,2.1
2016,"2016-08-21",50,42,"11/8/2016",79,8,48.1,46,2.1
2016,"2016-08-20",44,38,"11/8/2016",80,6,48.1,46,2.1
2016,"2016-08-20",47,42,"11/8/2016",80,5,48.1,46,2.1
2016,"2016-08-17",41,36,"11/8/2016",83,5,48.1,46,2.1
2016,"2016-08-16",48,35,"11/8/2016",84,13,48.1,46,2.1
2016,"2016-08-15",50,40,"11/8/2016",85,10,48.1,46,2.1
2016,"2016-08-14",44,37,"11/8/2016",86,7,48.1,46,2.1
2016,"2016-08-14",51,45,"11/8/2016",86,6,48.1,46,2.1
2016,"2016-08-14",50,41,"11/8/2016",86,9,48.1,46,2.1
2016,"2016-08-10",42,36,"11/8/2016",90,6,48.1,46,2.1
2016,"2016-08-08",50,44,"11/8/2016",92,6,48.1,46,2.1
2016,"2016-08-07",45,39,"11/8/2016",93,6,48.1,46,2.1
2016,"2016-08-07",49,44,"11/8/2016",93,5,48.1,46,2.1
2016,"2016-08-07",51,41,"11/8/2016",93,10,48.1,46,2.1
2016,"2016-08-05",46,37,"11/8/2016",95,9,48.1,46,2.1
2016,"2016-08-04",51,44,"11/8/2016",96,7,48.1,46,2.1
2016,"2016-08-04",46,39,"11/8/2016",96,7,48.1,46,2.1
2016,"2016-08-03",48,33,"11/8/2016",97,15,48.1,46,2.1
2016,"2016-08-03",47,38,"11/8/2016",97,9,48.1,46,2.1
2016,"2016-08-03",43,39,"11/8/2016",97,4,48.1,46,2.1
2016,"2016-08-02",49,39,"11/8/2016",98,10,48.1,46,2.1
2016,"2016-07-31",52,43,"11/8/2016",100,9,48.1,46,2.1
2016,"2016-07-31",47,41,"11/8/2016",100,6,48.1,46,2.1
2016,"2016-07-31",49,46,"11/8/2016",100,3,48.1,46,2.1
2016,"2016-07-31",50,42,"11/8/2016",100,8,48.1,46,2.1
2016,"2016-07-30",43,40,"11/8/2016",101,3,48.1,46,2.1
2016,"2016-07-30",50,45,"11/8/2016",101,5,48.1,46,2.1
2016,"2016-07-29",40,35,"11/8/2016",102,5,48.1,46,2.1
2016,"2016-07-27",43,42,"11/8/2016",104,1,48.1,46,2.1
2016,"2016-07-24",43,44,"11/8/2016",107,-1,48.1,46,2.1
2016,"2016-07-24",45,48,"11/8/2016",107,-3,48.1,46,2.1
2016,"2016-07-24",40,44,"11/8/2016",107,-4,48.1,46,2.1
2016,"2016-07-24",46,42,"11/8/2016",107,4,48.1,46,2.1
2016,"2016-07-24",46,45,"11/8/2016",107,1,48.1,46,2.1
2016,"2016-07-22",49,51,"11/8/2016",109,-2,48.1,46,2.1
2016,"2016-07-20",43,42,"11/8/2016",111,1,48.1,46,2.1
2016,"2016-07-20",40,36,"11/8/2016",111,4,48.1,46,2.1
2016,"2016-07-19",42,43,"11/8/2016",112,-1,48.1,46,2.1
2016,"2016-07-18",50,43,"11/8/2016",113,7,48.1,46,2.1
2016,"2016-07-17",46,45,"11/8/2016",114,1,48.1,46,2.1
2016,"2016-07-16",41,39,"11/8/2016",115,2,48.1,46,2.1
2016,"2016-07-16",49,42,"11/8/2016",115,7,48.1,46,2.1
2016,"2016-07-15",46,41,"11/8/2016",116,5,48.1,46,2.1
2016,"2016-07-14",47,43,"11/8/2016",117,4,48.1,46,2.1
2016,"2016-07-13",37,44,"11/8/2016",118,-7,48.1,46,2.1
2016,"2016-07-13",46,41,"11/8/2016",118,5,48.1,46,2.1
2016,"2016-07-12",40,40,"11/8/2016",119,0,48.1,46,2.1
2016,"2016-07-10",42,41,"11/8/2016",121,1,48.1,46,2.1
2016,"2016-07-10",47,44,"11/8/2016",121,3,48.1,46,2.1
2016,"2016-07-09",42,39,"11/8/2016",122,3,48.1,46,2.1
2016,"2016-07-06",44,33,"11/8/2016",125,11,48.1,46,2.1
2016,"2016-07-05",40,42,"11/8/2016",126,-2,48.1,46,2.1
2016,"2016-07-04",41,40,"11/8/2016",127,1,48.1,46,2.1
2016,"2016-07-03",48,43,"11/8/2016",128,5,48.1,46,2.1
2016,"2016-06-29",39,43,"11/8/2016",132,-4,48.1,46,2.1
2016,"2016-06-29",46,40,"11/8/2016",132,6,48.1,46,2.1
2016,"2016-06-29",42,32,"11/8/2016",132,10,48.1,46,2.1
2016,"2016-06-29",44,40,"11/8/2016",132,4,48.1,46,2.1
2016,"2016-06-28",50,46,"11/8/2016",133,4,48.1,46,2.1
2016,"2016-06-28",48,44,"11/8/2016",133,4,48.1,46,2.1
2016,"2016-06-28",44,38,"11/8/2016",133,6,48.1,46,2.1
2016,"2016-06-27",44,39,"11/8/2016",134,5,48.1,46,2.1
2016,"2016-06-27",42,40,"11/8/2016",134,2,48.1,46,2.1
2016,"2016-06-26",49,41,"11/8/2016",135,8,48.1,46,2.1
2016,"2016-06-26",51,42,"11/8/2016",135,9,48.1,46,2.1
2016,"2016-06-23",51,39,"11/8/2016",138,12,48.1,46,2.1
2016,"2016-06-23",46,41,"11/8/2016",138,5,48.1,46,2.1
2016,"2016-06-22",44,34,"11/8/2016",139,10,48.1,46,2.1
2016,"2016-06-21",44,39,"11/8/2016",140,5,48.1,46,2.1
2016,"2016-06-20",50,41,"11/8/2016",141,9,48.1,46,2.1
2016,"2016-06-20",42,40,"11/8/2016",141,2,48.1,46,2.1
2016,"2016-06-19",47,42,"11/8/2016",142,5,48.1,46,2.1
2016,"2016-06-19",47,40,"11/8/2016",142,7,48.1,46,2.1
2016,"2016-06-19",48,42,"11/8/2016",142,6,48.1,46,2.1
2016,"2016-06-16",50,45,"11/8/2016",145,5,48.1,46,2.1
2016,"2016-06-15",44,39,"11/8/2016",146,5,48.1,46,2.1
2016,"2016-06-15",41,32,"11/8/2016",146,9,48.1,46,2.1
2016,"2016-06-13",40,35,"11/8/2016",148,5,48.1,46,2.1
2016,"2016-06-13",54,36,"11/8/2016",148,18,48.1,46,2.1
2016,"2016-06-13",43,37,"11/8/2016",148,6,48.1,46,2.1
2016,"2016-06-12",49,42,"11/8/2016",149,7,48.1,46,2.1
2016,"2016-06-09",42,37,"11/8/2016",152,5,48.1,46,2.1
2016,"2016-06-08",42,39,"11/8/2016",153,3,48.1,46,2.1
2016,"2016-06-08",42,34,"11/8/2016",153,8,48.1,46,2.1
2016,"2016-06-07",42,38,"11/8/2016",154,4,48.1,46,2.1
2016,"2016-06-05",44,41,"11/8/2016",156,3,48.1,46,2.1
2016,"2016-06-05",44,40,"11/8/2016",156,4,48.1,46,2.1
2016,"2016-06-05",45,40,"11/8/2016",156,5,48.1,46,2.1
2016,"2016-06-05",48,44,"11/8/2016",156,4,48.1,46,2.1
2016,"2016-06-01",39,38,"11/8/2016",160,1,48.1,46,2.1
2016,"2016-06-01",43,34,"11/8/2016",160,9,48.1,46,2.1
2016,"2016-05-30",42,39,"11/8/2016",162,3,48.1,46,2.1
2016,"2016-05-30",45,41,"11/8/2016",162,4,48.1,46,2.1
2016,"2016-05-29",47,45,"11/8/2016",163,2,48.1,46,2.1
2016,"2016-05-25",41,36,"11/8/2016",167,5,48.1,46,2.1
2016,"2016-05-24",40,39,"11/8/2016",168,1,48.1,46,2.1
2016,"2016-05-23",42,41,"11/8/2016",169,1,48.1,46,2.1
2016,"2016-05-23",42,40,"11/8/2016",169,2,48.1,46,2.1
2016,"2016-05-22",47,43,"11/8/2016",170,4,48.1,46,2.1
2016,"2016-05-20",46,46,"11/8/2016",172,0,48.1,46,2.1
2016,"2016-05-19",44,42,"11/8/2016",173,2,48.1,46,2.1
2016,"2016-05-19",44,46,"11/8/2016",173,-2,48.1,46,2.1
2016,"2016-05-19",46,43,"11/8/2016",173,3,48.1,46,2.1
2016,"2016-05-18",37,42,"11/8/2016",174,-5,48.1,46,2.1
2016,"2016-05-18",41,36,"11/8/2016",174,5,48.1,46,2.1
2016,"2016-05-17",42,45,"11/8/2016",175,-3,48.1,46,2.1
2016,"2016-05-17",47,41,"11/8/2016",175,6,48.1,46,2.1
2016,"2016-05-16",46,42,"11/8/2016",176,4,48.1,46,2.1
2016,"2016-05-15",42,40,"11/8/2016",177,2,48.1,46,2.1
2016,"2016-05-15",48,45,"11/8/2016",177,3,48.1,46,2.1
2016,"2016-05-11",41,37,"11/8/2016",181,4,48.1,46,2.1
2016,"2016-05-10",51,49,"11/8/2016",182,2,48.1,46,2.1
2016,"2016-05-09",42,40,"11/8/2016",183,2,48.1,46,2.1
2016,"2016-05-09",47,41,"11/8/2016",183,6,48.1,46,2.1
2016,"2016-05-09",44,38,"11/8/2016",183,6,48.1,46,2.1
2016,"2016-05-08",49,44,"11/8/2016",184,5,48.1,46,2.1
2016,"2016-05-04",45,36,"11/8/2016",188,9,48.1,46,2.1
2016,"2016-05-02",45,40,"11/8/2016",190,5,48.1,46,2.1
2016,"2016-05-01",54,41,"11/8/2016",191,13,48.1,46,2.1
2016,"2016-05-01",43,37,"11/8/2016",191,6,48.1,46,2.1
2016,"2016-04-29",46,39,"11/8/2016",193,7,48.1,46,2.1
2016,"2016-04-28",39,41,"11/8/2016",194,-2,48.1,46,2.1
2016,"2016-04-28",47,40,"11/8/2016",194,7,48.1,46,2.1
2016,"2016-04-27",43,36,"11/8/2016",195,7,48.1,46,2.1
2016,"2016-04-26",38,38,"11/8/2016",196,0,48.1,46,2.1
2016,"2016-04-26",43,40,"11/8/2016",196,3,48.1,46,2.1
2016,"2016-04-24",50,39,"11/8/2016",198,11,48.1,46,2.1
2016,"2016-04-24",44,36,"11/8/2016",198,8,48.1,46,2.1
2016,"2016-04-22",46,40,"11/8/2016",200,6,48.1,46,2.1
2016,"2016-04-20",47,40,"11/8/2016",202,7,48.1,46,2.1
2016,"2016-04-20",46,43,"11/8/2016",202,3,48.1,46,2.1
2016,"2016-04-20",44,33,"11/8/2016",202,11,48.1,46,2.1
2016,"2016-04-17",46,37,"11/8/2016",205,9,48.1,46,2.1
2016,"2016-04-17",48,39,"11/8/2016",205,9,48.1,46,2.1
2016,"2016-04-14",50,39,"11/8/2016",208,11,48.1,46,2.1
2016,"2016-04-13",48,41,"11/8/2016",209,7,48.1,46,2.1
2016,"2016-04-13",43,34,"11/8/2016",209,9,48.1,46,2.1
2016,"2016-04-12",50,40,"11/8/2016",210,10,48.1,46,2.1
2016,"2016-04-11",46,37,"11/8/2016",211,9,48.1,46,2.1
2016,"2016-04-10",43,36,"11/8/2016",212,7,48.1,46,2.1
2016,"2016-04-06",39,34,"11/8/2016",216,5,48.1,46,2.1
2016,"2016-04-03",45,38,"11/8/2016",219,7,48.1,46,2.1
2016,"2016-04-03",45,33,"11/8/2016",219,12,48.1,46,2.1
2016,"2016-04-02",47,35,"11/8/2016",220,12,48.1,46,2.1
2016,"2016-03-31",50,41,"11/8/2016",222,9,48.1,46,2.1
2016,"2016-03-31",45,32,"11/8/2016",222,13,48.1,46,2.1
2016,"2016-03-29",45,41,"11/8/2016",224,4,48.1,46,2.1
2016,"2016-03-26",48,41,"11/8/2016",227,7,48.1,46,2.1
2016,"2016-03-26",44,38,"11/8/2016",227,6,48.1,46,2.1
2016,"2016-03-24",53,40,"11/8/2016",229,13,48.1,46,2.1
2016,"2016-03-23",43,35,"11/8/2016",230,8,48.1,46,2.1
2016,"2016-03-23",48,41,"11/8/2016",230,7,48.1,46,2.1
2016,"2016-03-22",49,38,"11/8/2016",231,11,48.1,46,2.1
2016,"2016-03-22",54,36,"11/8/2016",231,18,48.1,46,2.1
2016,"2016-03-21",45,38,"11/8/2016",232,7,48.1,46,2.1
2016,"2016-03-21",46,40,"11/8/2016",232,6,48.1,46,2.1
2016,"2016-03-20",48,38,"11/8/2016",233,10,48.1,46,2.1
2016,"2016-03-20",50,40,"11/8/2016",233,10,48.1,46,2.1
2016,"2016-03-20",53,41,"11/8/2016",233,12,48.1,46,2.1
2016,"2016-03-18",45,37,"11/8/2016",235,8,48.1,46,2.1
2016,"2016-03-16",42,37,"11/8/2016",237,5,48.1,46,2.1
2016,"2016-03-13",47,37,"11/8/2016",240,10,48.1,46,2.1
2016,"2016-03-12",43,42,"11/8/2016",241,1,48.1,46,2.1
2016,"2016-03-09",45,31,"11/8/2016",244,14,48.1,46,2.1
2016,"2016-03-06",46,38,"11/8/2016",247,8,48.1,46,2.1
2016,"2016-03-06",51,38,"11/8/2016",247,13,48.1,46,2.1
2016,"2016-03-06",50,41,"11/8/2016",247,9,48.1,46,2.1
2016,"2016-03-02",46,35,"11/8/2016",251,11,48.1,46,2.1
2016,"2016-03-01",41,36,"11/8/2016",252,5,48.1,46,2.1
2016,"2016-02-27",44,43,"11/8/2016",255,1,48.1,46,2.1
2016,"2016-02-27",52,44,"11/8/2016",255,8,48.1,46,2.1
2016,"2016-02-24",44,35,"11/8/2016",258,9,48.1,46,2.1
2016,"2016-02-17",47,42,"11/8/2016",265,5,48.1,46,2.1
2016,"2016-02-17",44,37,"11/8/2016",265,7,48.1,46,2.1
2016,"2016-02-16",43,42,"11/8/2016",266,1,48.1,46,2.1
2016,"2016-02-16",50,40,"11/8/2016",266,10,48.1,46,2.1
2016,"2016-02-15",43,45,"11/8/2016",267,-2,48.1,46,2.1
2016,"2016-02-15",44,43,"11/8/2016",267,1,48.1,46,2.1
2016,"2016-02-10",44,34,"11/8/2016",272,10,48.1,46,2.1
2016,"2016-02-07",45,40,"11/8/2016",275,5,48.1,46,2.1
2016,"2016-02-04",46,41,"11/8/2016",278,5,48.1,46,2.1
2016,"2016-02-03",47,40,"11/8/2016",279,7,48.1,46,2.1
2016,"2016-02-03",44,36,"11/8/2016",279,8,48.1,46,2.1
2016,"2016-01-24",45,39,"11/8/2016",289,6,48.1,46,2.1
2016,"2016-01-24",48,47,"11/8/2016",289,1,48.1,46,2.1
2016,"2016-01-20",45,45,"11/8/2016",293,0,48.1,46,2.1
2016,"2016-01-17",44,42,"11/8/2016",296,2,48.1,46,2.1
2016,"2016-01-13",51,41,"11/8/2016",300,10,48.1,46,2.1
2016,"2016-01-10",49,51,"11/8/2016",303,-2,48.1,46,2.1
2016,"2016-01-10",42,44,"11/8/2016",303,-2,48.1,46,2.1
2016,"2016-01-07",44,47,"11/8/2016",306,-3,48.1,46,2.1
2016,"2015-12-23",37,36,"11/8/2016",321,1,48.1,46,2.1
2016,"2015-12-21",49,47,"11/8/2016",323,2,48.1,46,2.1
2016,"2015-12-20",48,46,"11/8/2016",324,2,48.1,46,2.1
2016,"2015-12-20",47,40,"11/8/2016",324,7,48.1,46,2.1
2016,"2015-12-17",46,43,"11/8/2016",327,3,48.1,46,2.1
2016,"2015-12-17",49,38,"11/8/2016",327,11,48.1,46,2.1
2016,"2015-12-15",46,41,"11/8/2016",329,5,48.1,46,2.1
2016,"2015-12-13",50,44,"11/8/2016",331,6,48.1,46,2.1
2016,"2015-12-09",50,40,"11/8/2016",335,10,48.1,46,2.1
2016,"2015-12-08",51,49,"11/8/2016",336,2,48.1,46,2.1
2016,"2015-12-07",40,45,"11/8/2016",337,-5,48.1,46,2.1
2016,"2015-12-06",47,44,"11/8/2016",338,3,48.1,46,2.1
2016,"2015-12-03",51,37,"11/8/2016",341,14,48.1,46,2.1
2016,"2015-12-02",52,41,"11/8/2016",342,11,48.1,46,2.1
2016,"2015-12-01",49,46,"11/8/2016",343,3,48.1,46,2.1
2016,"2015-11-30",47,41,"11/8/2016",344,6,48.1,46,2.1
2016,"2015-11-19",41,46,"11/8/2016",355,-5,48.1,46,2.1
2016,"2015-11-17",45,44,"11/8/2016",357,1,48.1,46,2.1
2016,"2015-11-16",44,43,"11/8/2016",358,1,48.1,46,2.1
2016,"2015-11-08",43,43,"11/8/2016",366,0,48.1,46,2.1
2016,"2015-11-04",56,41,"11/8/2016",370,15,48.1,46,2.1
2016,"2015-11-02",46,43,"11/8/2016",372,3,48.1,46,2.1
2016,"2015-11-01",44,44,"11/8/2016",373,0,48.1,46,2.1
2016,"2015-10-31",41,37,"11/8/2016",374,4,48.1,46,2.1
2016,"2015-10-29",50,42,"11/8/2016",376,8,48.1,46,2.1
2016,"2015-10-26",51,49,"11/8/2016",379,2,48.1,46,2.1
2016,"2015-10-25",43,43,"11/8/2016",380,0,48.1,46,2.1
2016,"2015-10-22",47,38,"11/8/2016",383,9,48.1,46,2.1
2016,"2015-10-19",44,41,"11/8/2016",386,3,48.1,46,2.1
2016,"2015-10-17",44,46,"11/8/2016",388,-2,48.1,46,2.1
2016,"2015-10-17",50,45,"11/8/2016",388,5,48.1,46,2.1
2016,"2015-10-12",40,45,"11/8/2016",393,-5,48.1,46,2.1
2016,"2015-10-12",43,41,"11/8/2016",393,2,48.1,46,2.1
2016,"2015-10-05",41,43,"11/8/2016",400,-2,48.1,46,2.1
2016,"2015-10-04",44,44,"11/8/2016",401,0,48.1,46,2.1
2016,"2015-10-01",48,52,"11/8/2016",404,-4,48.1,46,2.1
2016,"2015-09-27",45,42,"11/8/2016",408,3,48.1,46,2.1
2016,"2015-09-24",49,39,"11/8/2016",411,10,48.1,46,2.1
2016,"2015-09-22",46,42,"11/8/2016",413,4,48.1,46,2.1
2016,"2015-09-21",45,43,"11/8/2016",414,2,48.1,46,2.1
2016,"2015-09-20",45,41,"11/8/2016",415,4,48.1,46,2.1
2016,"2015-09-13",44,40,"11/8/2016",422,4,48.1,46,2.1
2016,"2015-09-10",46,43,"11/8/2016",425,3,48.1,46,2.1
2016,"2015-09-09",53,40,"11/8/2016",426,13,48.1,46,2.1
2016,"2015-09-08",43,47,"11/8/2016",427,-4,48.1,46,2.1
2016,"2015-09-08",48,48,"11/8/2016",427,0,48.1,46,2.1
2016,"2015-09-07",42,43,"11/8/2016",428,-1,48.1,46,2.1
2016,"2015-09-03",40,45,"11/8/2016",432,-5,48.1,46,2.1
2016,"2015-08-30",46,44,"11/8/2016",436,2,48.1,46,2.1
2016,"2015-08-30",43,42,"11/8/2016",436,1,48.1,46,2.1
2016,"2015-08-25",45,41,"11/8/2016",441,4,48.1,46,2.1
2016,"2015-08-22",46,54,"11/8/2016",444,-8,48.1,46,2.1
2016,"2015-08-16",51,45,"11/8/2016",450,6,48.1,46,2.1
2016,"2015-08-13",47,42,"11/8/2016",453,5,48.1,46,2.1
2016,"2015-08-10",43,29,"11/8/2016",456,14,48.1,46,2.1
2016,"2015-08-09",47,41,"11/8/2016",457,6,48.1,46,2.1
2016,"2015-08-01",50,49,"11/8/2016",465,1,48.1,46,2.1
2016,"2015-07-28",49,40,"11/8/2016",469,9,48.1,46,2.1
2016,"2015-07-28",48,36,"11/8/2016",469,12,48.1,46,2.1
2016,"2015-07-28",54,38,"11/8/2016",469,16,48.1,46,2.1
2016,"2015-07-25",56,40,"11/8/2016",472,16,48.1,46,2.1
2016,"2015-07-21",50,37,"11/8/2016",476,13,48.1,46,2.1
2016,"2015-07-12",51,34,"11/8/2016",485,17,48.1,46,2.1
2016,"2015-06-28",59,35,"11/8/2016",499,24,48.1,46,2.1
2016,"2015-06-23",51,34,"11/8/2016",504,17,48.1,46,2.1
2016,"2015-06-22",46,35,"11/8/2016",505,11,48.1,46,2.1
2016,"2015-05-26",50,32,"11/8/2016",532,18,48.1,46,2.1
